阿根廷地理	agentingdili	agtdl
阿帕克和卓传	apakehezhuochuan	apkhzc
暗黑传说	anheichuanshuo	ahcs
暗黑圣经传承	anheishengjingchuancheng	ahsjcc
安乐集	anleji	alj
安流传授纪要	anliuchuanshoujiyao	alcsjy
暗行者	anxingzhe	axz
暗夜行者	anyexingzhe	ayxz
八大人觉经	badarenjuejing	bdrjj
八奇屠龙	baqitulong	bqtl
八重法	bazhongfa	bzf
八周强身法	bazhouqiangshenfa	bzqsf
白毛女新传	baimaonvxinzhuan	bmnxz
百战奇法	baizhanqifa	bzqf
薄壁弹性杆件	baobitanxingganjian	bbtxgj
宝行王正论	baoxingwangzhenglun	bxwzl
碑传集	beichuanji	bcj
本朝高僧传	benchaogaosengchuan	bcgsc
彼岸天都	biantiandu	batd
比丘尼传	biqiunichuan	bqnc
比翼传奇	biyichuanqi	bycq
边荒传说	bianhuangchuanshuo	bhcs
病后奇遇	binghouqiyu	bhqy
并行排序算法	bingxingpaixusuanfa	bxpxsf
渤海地质	bohaidizhi	bhdz
渤海国志长编	bohaiguozhichangbian	bhgzcb
波兰自然地理	bolanzirandili	blzrdl
不灭传说	bumiechuanshuo	bmcs
不死传说	busichuanshuo	bscs
补续高僧传	buxugaosengchuan	bxgsc
採花行	caihuaxing	chx
残兵传说	canbingchuanshuo	cbcs
曹溪宝林传	caoxibaolinchuan	cxblc
曾胡治兵语录	cenghuzhibingyulu	chzbyl
曾经	cengjing	cj
查理大帝传	chalidadizhuan	clddz
禅林僧宝传	chanlinsengbaochuan	clsbc
长阿含经	changahanjing	cahj
长安乱	changanluan	cal
长坂坡救阿斗	changbanpojiuadou	cbpjad
长壁开采法	changbikaicaifa	cbkcf
长刀无痕	changdaowuhen	cdwh
昌都卡若	changdukaruo	cdkr
长短经	changduanjing	cdj
长短要术	changduanyaoshu	cdys
长沙发掘报告	changshafajuebaogao	csfjbg
长生殿	changshengdian	csd
长水集	changshuiji	csj
长松茹退	changsongrutui	csrt
长兴学记	changxingxueji	cxxj
超常感觉	chaochangganjue	ccgj
朝汉词典	chaohancidian	chcd
朝话	chaohua	ch
超级艳遇传说	chaojiyanyuchuanshuo	cjyycs
朝觐途记	chaojintuji	cjtj
朝宋	chaosong	cs
朝鲜佛教通史	chaoxianfojiaotongshi	cxfjts
朝鲜通史	chaoxiantongshi	cxts
陈阿娇新传	chenajiaoxinzhuan	cajxz
成都的私处	chengdudesichu	cddsc
成吉思汗传	chengjisihanchuan	cjshc
城市绿地规划	chengshilvdiguihua	csldgh
诚斋易传	chengzhaiyizhuan	czyz
成长的记忆	chengzhangdejiyi	czdjy
侈乐	chile	cl
重编国语辞典	chongbianguoyucidian	cbgycd
重返呼啸山庄	chongfanhuxiaoshanzhuang	cfhxsz
重建帝国	chongjiandiguo	cjdg
重建怀圣寺记	chongjianhuaishengsiji	cjhssj
重启	chongqi	cq
重生	chongsheng	cs
重生传说	chongshengchuanshuo	cscs
重生法医	chongshengfayi	csfy
重生混元道	chongshenghunyuandao	cshyd
重生敛财	chongshengliancai	cslc
重生平淡人生	chongshengpingdanrensheng	cspdrs
重生武仙	chongshengwuxian	cswx
重生在未来	chongshengzaiweilai	cszwl
重生在异界	chongshengzaiyijie	cszyj
重生之梦	chongshengzhimeng	cszm
重生追美记	chongshengzhuimeiji	cszmj
重修清净寺记	chongxiuqingjingsiji	cxqjsj
丑女当自强	chounvdangziqiang	cndzq
畴人传	chourenchuan	crc
初刻拍案惊奇	chukepaianjingqi	ckpajq
传灯录	chuandenglu	cdl
传灯玉英集	chuandengyuyingji	cdyyj
传递现象	chuandixianxiang	cdxx
传法宝纪	chuanfabaoji	cfbj
传法正宗记	chuanfazhengzongji	cfzzj
传感器技术	chuanganqijishu	cgqjs
传光录	chuanguanglu	cgl
传热	chuanre	cr
传习录	chuanxilu	cxl
船长手册	chuanzhangshouce	czsc
传质操作	chuanzhicaozuo	czcz
传质原理	chuanzhiyuanli	czyl
春秋传	chunqiuchuan	cqc
春秋公羊传	chunqiugongyangchuan	cqgyc
春秋穀梁传	chunqiuguliangchuan	cqglc
春秋外传	chunqiuwaizhuan	cqwz
春秋左氏传	chunqiuzuoshizhuan	cqzsz
春秋左传诂	chunqiuzuozhuangu	cqzzg
刺客魔传	cikemozhuan	ckmz
此时此地	cishicidi	cscd
从地球到月球	congdiqiudaoyueqiu	cdqdyq
大调教师	dadiaojiaoshi	ddjs
达芬奇密码	dafenqimima	dfqmm
大和卓传	dahezhuochuan	dhzc
大觉禅师语录	dajiaochanshiyulu	djcsyl
大乐	dale	dl
大陆坡地质学	dalupodizhixue	dlpdzx
大明高僧传	daminggaosengchuan	dmgsc
大闹长坂坡	danaochangbanpo	dncbp
大人先生传	darenxianshengchuan	drxsc
大唐双龙传	datangshuanglongzhuan	dtslz
大唐行镖	datangxingbiao	dtxb
大西洋地质学	daxiyangdizhixue	dxydzx
弹痕	danhen	dh
导弹的发展	daodandefazhan	dddfz
捣蛋鹦鹉外传	daodanyingwuwaizhuan	ddywwz
道行究竟	daohengjiujing	dhjj
地表形态学	dibiaoxingtaixue	dbxtx
地层地质学	dicengdizhixue	dcdzx
地层学原理	dicengxueyuanli	dcxyl
地磁学	dicixue	dcx
帝国调教师	diguotiaojiaoshi	dgtjs
帝皇猎艳行	dihuanglieyanxing	dhlyx
地理学	dilixue	dlx
地理学概论	dilixuegailun	dlxgl
地理志	dilizhi	dlz
地面车辆原理	dimiancheliangyuanli	dmclyl
地名辞典	dimingcidian	dmcd
地球化学	diqiuhuaxue	dqhx
地球化学导论	diqiuhuaxuedaolun	dqhxdl
地球化学概论	diqiuhuaxuegailun	dqhxgl
地球化学手册	diqiuhuaxueshouce	dqhxsc
地球外的中继	diqiuwaidezhongji	dqwdzj
地史学教程	dishixuejiaocheng	dsxjc
地史学原理	dishixueyuanli	dsxyl
地图投影学	ditutouyingxue	dttyx
地图学原理	dituxueyuanli	dtxyl
地文学	diwenxue	dwx
地下水动力学	dixiashuidonglixue	dxsdlx
地下水力采煤	dixiashuilicaimei	dxslcm
地下王朝	dixiawangchao	dxwc
地学通论	dixuetonglun	dxtl
第一美女传	diyimeinvchuan	dymnc
地狱黑客	diyuheike	dyhk
地藏十轮经	dizangshilunjing	dzslj
地震地层学	dizhendicengxue	dzdcx
地震勘探	dizhenkantan	dzkt
地质力学概论	dizhilixuegailun	dzlxgl
地质学原理	dizhixueyuanli	dzxyl
店小二传奇	dianxiaoerchuanqi	dxecq
调研文集	diaoyanwenji	dywj
定鼎奇闻	dingdingqiwen	ddqw
东方地狱火	dongfangdiyuhuo	dfdyh
东国高僧传	dongguogaosengchuan	dggsc
都市藏龙	dushicanglong	dscl
都市地理学	dushidilixue	dsdlx
都市法师	dushifashi	dsfs
都市风流	dushifengliu	dsfl
都市花盗	dushihuadao	dshd
都市狙魔人	dushijumoren	dsjmr
都市空间	dushikongjian	dskj
都市炼宝王	dushilianbaowang	dslbw
都市龙游	dushilongyou	dsly
都市魔幻物语	dushimohuanwuyu	dsmhwy
都市模式	dushimoshi	dsms
都市品香录	dushipinxianglu	dspxl
都市神龙传奇	dushishenlongchuanqi	dsslcq
都市神人	dushishenren	dssr
都市天龙	dushitianlong	dstl
都市侠客行	dushixiakexing	dsxkx
都市小钢炮	dushixiaogangpao	dsxgp
都市妖奇谈	dushiyaoqitan	dsyqt
对比折射法	duibizheshefa	dbzsf
多重线性代数	duochongxianxingdaishu	dcxxds
二刻拍案惊奇	erkepaianjingqi	ekpajq
儿女英雄传	ernvyingxiongzhuan	enyxz
二入四行论	errusihanglun	ershl
儿子的遗传	erzideyichuan	ezdyc
法国传记词典	faguozhuanjicidian	fgzjcd
法华传记	fahuazhuanji	fhzj
发生遗传学	fashengyichuanxue	fsycx
法师传奇	fashichuanqi	fscq
法显传	faxianchuan	fxc
法藏和尚传	fazangheshangchuan	fzhsc
凡人修仙传	fanrenxiuxianchuan	frxxc
方等三昧行法	fangdengsanmeixingfa	fdsmxf
飞机强度计算	feijiqiangdujisuan	fjqdjs
飞龙全传	feilongquanzhuan	flqz
费路西传奇	feiluxichuanqi	flxcq
废人传奇	feirenchuanqi	frcq
飞行机器	feixingjiqi	fxjq
冯卡门全集	fengkamenquanji	fkmqj
疯狂传说	fengkuangchuanshuo	fkcs
风流艳侠传奇	fengliuyanxiachuanqi	flyxcq
疯魔传说	fengmochuanshuo	fmcs
枫叶奇情	fengyeqiqing	fyqq
风云传说	fengyunchuanshuo	fycs
风之暗黑传	fengzhianheichuan	fzahc
佛本行集经	fobenhangjijing	fbhjj
佛地经	fodijing	fdj
佛地经论	fodijinglun	fdjl
佛所行赞	fosuoxingzan	fsxz
付法藏因缘传	fufazangyinyuanchuan	ffzyyc
福乐智慧	fulezhihui	flzh
缚美传	fumeichuan	fmc
傅邪真传说	fuxiezhenchuanshuo	fxzcs
概率论	gailvlun	gll
改造传统农业	gaizaochuantongnongye	gzctny
感觉的分析	ganjuedefenxi	gjdfx
感觉心理	ganjuexinli	gjxl
肛花盛开	ganghuashengkai	ghsk
高超音速粘流	gaochaoyinsuzhanliu	gcyszl
高贵者的品行	gaoguizhedepinxing	ggzdpx
高僧传	gaosengchuan	gsc
高僧法显传	gaosengfaxianchuan	gsfxc
高识传	gaoshichuan	gsc
高太尉新传	gaotaiweixinzhuan	gtwxz
高衙内新传	gaoyaneixinzhuan	gynxz
格萨尔王传	gesaerwangchuan	gsewc
共通感觉论	gongtongganjuelun	gtgjl
公羊传	gongyangchuan	gyc
公冶长	gongyechang	gyc
工业地理学	gongyedilixue	gydlx
沟通行动理论	goutongxingdonglilun	gtxdll
构造地质学	gouzaodizhixue	gzdzx
古地理学	gudilixue	gdlx
穀梁传	guliangchuan	glc
古清凉传	guqingliangchuan	gqlc
古音王传	guyinwangchuan	gywc
孤月行	guyuexing	gyx
古尊宿语录	guzunsuyulu	gzsyl
管理行为	guanlixingwei	glxw
观心觉梦钞	guanxinjuemengchao	gxjmc
广百将传	guangbaijiangchuan	gbjc
国朝学案小识	guochaoxueanxiaoshi	gcxaxs
海底地质学	haididizhixue	hddzx
海东高僧传	haidonggaosengchuan	hdgsc
海上花列传	haishanghualiezhuan	hshlz
海洋重力学	haiyangzhonglixue	hyzlx
韩国娱乐大亨	hanguoyuledaheng	hgyldh
汉上易传	hanshangyizhuan	hsyz
韩诗外传	hanshiwaizhuan	hswz
寒天行侠传	hantianxingxiachuan	htxxc
行水金鉴	hangshuijinjian	hsjj
好逑传	haoqiuchuan	hqc
浩然正气传	haoranzhengqichuan	hrzqc
何春传奇史	hechunchuanqishi	hccqs
合锦回文传	hejinhuiwenchuan	hjhwc
和卓传	hezhuochuan	hzc
黑客传说	heikechuanshuo	hkcs
黑雪传说	heixuechuanshuo	hxcs
横浦心传	hengpuxinchuan	hpxc
横行在异世	hengxingzaiyishi	hxzys
红都秘事	hongdumishi	hdms
洪范传	hongfanchuan	hfc
洪范五行传	hongfanwuxingchuan	hfwxc
红风传	hongfengchuan	hfc
红绿灯单行线	honglvdengdanxingxian	hlddxx
弘赞法华传	hongzanfahuachuan	hzfhc
狐狸缘全传	huliyuanquanzhuan	hlyqz
花的奇妙世界	huadeqimiaoshijie	hdqmsj
花都猎人	huadulieren	hdlr
花花公子传奇	huahuagongzichuanqi	hhgzcq
花开堪折	huakaikanzhe	hkkz
画图缘小传	huatuyuanxiaozhuan	htyxz
华严经传记	huayanjingzhuanji	hyjzj
欢乐今宵	huanlejinxiao	hljx
换母俱乐部	huanmujulebu	hmjlb
幻想传说	huanxiangchuanshuo	hxcs
还乡团系列	huanxiangtuanxilie	hxtxl
还真道	huanzhendao	hzd
皇朝藩部要略	huangchaofanbuyaolue	hcfbyl
皇朝秘使	huangchaomishi	hcms
皇朝秘史	huangchaomishihuangchaomishi	hcmshcms
皇朝艳史	huangchaoyanshi	hcys
黄祸前传	huanghuoqianzhuan	hhqz
黄祸前传花劫	huanghuoqianzhuanhuajie	hhqzhj
皇家娱乐指南	huangjiayulezhinan	hjylzn
黄金传系	huangjinchuanxi	hjcx
黄金神传	huangjinshenchuan	hjsc
黄蓉新传	huangrongxinzhuan	hrxz
荒唐传说	huangtangchuanshuo	htcs
黄镇传	huangzhenchuan	hzc
火箭和导弹	huojianhedaodan	hjhdd
货殖列传	huozhiliezhuan	hzlz
极道修行录	jidaoxiuxinglu	jdxxl
基地	jidi	jd
济公全传	jigongquanzhuan	jgqz
级乳牛列传	jiruniuliezhuan	jrnlz
机神传奇	jishenchuanqi	jscq
家畜传染病	jiachuchuanranbing	jccrb
家族的传统	jiazudechuantong	jzdct
降水理论史	jiangshuililunshi	jslls
教外别传	jiaowaibiechuan	jwbc
教行信证	jiaoxingxinzheng	jxxz
教育的荒地	jiaoyudehuangdi	jydhd
教育行政	jiaoyuxingzheng	jyxz
胶洲女烈传	jiaozhounvliechuan	jznlc
姐弟相奸传说	jiedixiangjianchuanshuo	jdxjcs
金瓶梅传奇	jinpingmeichuanqi	jpmcq
金赢传	jinyingchuan	jyc
金鹰英雄传	jinyingyingxiongzhuan	jyyxz
金庸列女传	jinyonglienvzhuan	jylnz
金云翘传	jinyunqiaochuan	jyqc
景德传灯录	jingdechuandenglu	jdcdl
京氏易传	jingshiyizhuan	jsyz
净土往生传	jingtuwangshengchuan	jtwsc
经行记	jingxingji	jxj
经学系传谱	jingxuexichuanpu	jxxcp
经传释词	jingzhuanshici	jzsc
九朝律考	jiuchaolvkao	jclk
九重天下	jiuchongtianxia	jctx
救济传	jiujichuan	jjc
九龙女传奇	jiulongnvchuanqi	jlncq
九命奇冤	jiumingqiyuan	jmqy
巨人传	jurenchuan	jrc
居士传	jushichuan	jsc
觉禅钞	juechanchao	jcc
觉悟	juewu	jw
卡菲	kafei	kf
卡门	kamen	km
喀什噶尔传	kashigaerchuan	ksgec
卡徒	katu	kt
勘探地球物理	kantandiqiuwuli	ktdqwl
抗天传	kangtianchuan	ktc
快乐岛	kuailedao	kld
快乐乱伦	kuaileluanlun	klll
快乐小魔术	kuailexiaomoshu	klxms
快乐养猫要诀	kuaileyangmaoyaojue	klymyj
快乐养鸟要诀	kuaileyangniaoyaojue	klynyj
快乐养犬要诀	kuaileyangquanyaojue	klyqyj
快乐游艺宫	kuaileyouyigong	klyyg
快士传	kuaishichuan	ksc
矿床地质学	kuangchuangdizhixue	kcdzx
浪迹花都	langjihuadu	ljhd
乐邦文类	lebangwenlei	lbwl
乐道歌	ledaoge	ldg
乐记	leji	lj
乐经	lejing	lj
乐论	lelun	ll
乐在工作	lezaigongzuo	lzgz
雷峰塔奇传	leifengtaqichuan	lftqc
历朝释氏资鉴	lichaoshishizijian	lcsszj
历尘传奇	lichenchuanqi	lccq
理论地理学	lilundelixue	lldlx
历史地理论集	lishidililunji	lsdllj
理学宗传	lixuezongchuan	lxzc
礼乐论	liyuelun	lyl
两个行星上	lianggexingxingshang	lgxxs
两晋南北朝史	liangjinnanbeichaoshi	ljnbcs
猎命师传奇	liemingshichuanqi	lmscq
猎魔卡片	liemokapian	lmkp
列女传	lienvzhuan	lnz
列强对华外交	lieqiangduihuawaijiao	lqdhwj
灵幻奇侠	linghuanqixia	lhqx
刘少奇选集	liushaoqixuanji	lsqxj
六双行动鞋	liushuangxingdongxie	lsxdx
柳庭舆地隅说	liutingyudiyushuo	ltydys
流行酷语	liuxingkuyu	lxky
六学僧传	liuxuesengchuan	lxsc
龙魔传说	longmochuanshuo	lmcs
龙魔神传	longmoshenchuan	lmsc
龙潜都市	longqiandushi	lqds
龙枪传奇	longqiangchuanqi	lqcq
龙神传说	longshenchuanshuo	lscs
龙翔都市	longxiangdushi	lxds
龙战士传说	longzhanshichuanshuo	lzscs
陆地水文学	ludishuiwenxue	ldswx
乱伦奇案	luanlunqian	llqa
论概率	lungailv	lgl
论空中飞行	lunkongzhongfeixing	lkzfx
论鸟的飞行	lunniaodefeixing	lndfx
论语传注问	lunyuchuanzhuwen	lyczw
骆冰淫传	luobingyinchuan	lbyc
罗摩功行录	luomogongxinglu	lmgxl
落雁传说	luoyanchuanshuo	lycs
吕布新传	lvbuxinzhuan	lbxz
旅行者的食粮	lvxingzhedeshiliang	lxzdsl
旅游客源地	lvyoukeyuandi	lykyd
马克思传	makesichuan	mksc
玛雅神龙传	mayashenlongchuan	myslc
梅杰传	meijiechuan	mjc
煤矿地下构筑	meikuangdixiagouzhu	mkdxgz
美少女调教	meishaonvtiaojiao	msntj
煤田地质学	meitiandizhixue	mtdzx
梦华传说	menghuachuanshuo	mhcs
梦幻穿行	menghuanchuanxing	mhcx
梦回天地	menghuitiandi	mhtd
妙好人传	miaohaorenchuan	mhrc
民国传记词典	minguozhuanjicidian	mgzjcd
明朝那些事儿	mingchaonaxieshier	mcnxse
明朝史略	mingchaoshilue	mcsl
明高僧传	minggaosengchuan	mgsc
明季三朝野史	mingjisanzhaoyeshi	mjszys
明觉禅师语录	mingjuechanshiyulu	mjcsyl
名僧传	mingsengchuan	msc
名哲言行录	mingzheyanxinglu	mzyxl
魔弹女教師	modannvjiaoshi	mdnjs
魔帝重生	modichongsheng	mdcs
魔机传说	mojichuanshuo	mjcs
魔神艳传	moshenyanchuan	msyc
殁世奇侠	moshiqixia	msqx
模特儿传奇	moteerchuanqi	mtecq
魔王重生	mowangchongsheng	mwcs
穆桂英外传	muguiyingwaizhuan	mgywz
木兰奇女传	mulanqinvchuan	mlqnc
牧师传说	mushichuanshuo	mscs
纳尼亚传奇	naniyachuanqi	nnycq
南朝秘史	nanchaomishi	ncms
南传大藏经	nanchuandazangjing	ncdzj
南传七论	nanchuanqilun	ncql
南德的中心地	nandedezhongxinde	nddzxd
南斯拉夫地理	nansilafudili	nslfdl
南岳单传记	nanyuedanchuanji	nydcj
内裤奇缘	neikuqiyuan	nkqy
逆天邪传	nitianxiechuan	ntxc
粘土矿物学	niantukuangwuxue	ntkwx
农地制度论	nongdizhidulun	ndzdl
女大学生宿舍	nvdaxueshengsushe	ndxsss
女生宿舍	nvshengsushe	nsss
女刑警队长	nvxingjingduizhang	nxjdz
匹克威克外传	pikeweikewaizhuan	pkwkwz
品行不良	pinxingbuliang	pxbl
菩萨地持经	pusadichijing	psdcj
菩提行经	putixingjing	ptxj
普贤行愿品	puxianxingyuanpin	pxxyp
奇才公子	qicaigongzi	qcgz
汽车钢板弹簧	qichegangbantanhuang	qcgbth
弃妇当自强	qifudangziqiang	qfdzq
奇幻天书	qihuantianshu	qhts
棋魂同人重生	qihuntongrenchongsheng	qhtrcs
七界传说	qijiechuanshuo	qjcs
齐勒坦传	qiletanchuan	qltc
麒麟降世	qilinjiangshi	qljs
绮楼重梦	qilouzhongmeng	qlzm
奇童江湖行	qitongjianghuxing	qtjhx
七系付法传	qixifufachuan	qxffc
奇袭怪鱼王	qixiguaiyuwang	qxgyw
奇异的雄海马	qiyidexionghaima	qydxhm
奇异积分方程	qiyijifenfangcheng	qyjffc
奇淫宝典	qiyinbaodian	qybd
奇淫宝鉴	qiyinbaojian	qybj
奇淫宝鉴系列	qiyinbaojianxilie	qybjxl
奇缘	qiyuan	qy
奇缘四部曲	qiyuansibuqu	qysbq
起重机手册	qizhongjishouce	qzjsc
起重机械	qizhongjixie	qzjx
千年奇遇记	qiannianqiyuji	qnqyj
强兵	qiangbing	qb
强奸后的爱恋	qiangjianhoudeailian	qjhdal
秦朝野史	qinchaoyeshi	qcys
清朝秘史	qingchaomishi	qcms
清代名人传略	qingdaimingrenzhuanlue	qdmrzl
情调晚餐	qingdiaowancan	qdwc
青海湖传	qinghaihuchuan	qhhc
情色白眉新传	qingsebaimeixinzhuan	qsbmxz
求法高僧传	qiufagaosengchuan	qfgsc
圈宠	quanchong	qc
犬神传	quanshenzhuan	qsz
热血长城	rexuechangcheng	rxcc
人地学原理	rendixueyuanli	rdxyl
人类地理学	renleidilixue	rldlx
任中杰传奇	renzhongjiechuanqi	rzjcq
入菩萨行论	rupusaxinglun	rpsxl
如意君传	ruyijunchuan	ryjc
三宝局长	sanbaojuzhang	sbjz
三国厚黑传	sanguohouheichuan	sghhc
三遂平妖传	sansuipingyaochuan	sspyc
三坛传戒正范	santanchuanjiezhengfan	stcjzf
三朝北盟会编	sanzhaobeimenghuibian	szbmhb
色女行动	senvxingdong	snxd
森林遗传学	senlinyichuanxue	slycx
僧传	sengchuan	sc
杀手传说	shashouchuanshuo	sscs
山地战的今昔	shandizhandejinxi	sdzdjx
善女人传	shannvrenchuan	snrc
山岳地理	shanyuedili	sydl
山中传奇	shanzhongchuanqi	szcq
尚书大传	shangshudazhuan	ssdz
少女情感地图	shaonvqingganditu	snqgdt
少女社会地图	shaonvshehuiditu	snshdt
少女生理地图	shaonvshengliditu	snsldt
少女降龙	shaonvxianglong	snxl
少女学习地图	shaonvxuexiditu	snxxdt
射雕淫女传	shediaoyinnvchuan	sdync
社会学传统	shehuixuechuantong	shxct
肾病自我调养	shenbingziwotiaoyang	sbzwty
神雕外传	shendiaowaizhuan	sdwz
神恋传奇	shenlianchuanqi	slcq
神秘论者园地	shenmilunzheyuandi	smlzyd
神奇的食物	shenqideshiwu	sqdsw
神僧传	shensengchuan	ssc
神仙传	shenxianchuan	sxc
圣朝破邪集	shengchaopoxieji	scpxj
圣女传奇	shengnvchuanqi	sncq
圣女传说	shengnvchuanshuo	sncs
盛世危言	shengshiweiyan	sswy
圣兽传说	shengshouchuanshuo	sscs
盛唐怜花	shengtanglianhua	stlh
圣徒列传	shengtuliezhuan	stlz
声无哀乐论	shengwuaiyuelun	swayl
盛夏的果实	shengxiadeguoshi	sxdgs
圣贤传	shengxianchuan	sxc
圣学重光	shengxuechongguang	sxcg
圣学宗传	shengxuezongchuan	sxzc
时代动漫音乐	shidaidongmanyinyue	sddmyy
十地经论	shidijinglun	sdjl
十地经论义记	shidijinglunyiji	sdjlyj
诗广传	shiguangchuan	sgc
诗集传	shijichuan	sjc
世界地理	shijiedili	sjdl
世界地名词典	shijiedimingcidian	sjdmcd
世界地名录	shijiediminglu	sjdml
世界地图集	shijiedituji	sjdtj
世界名人全传	shijiemingrenquanzhuan	sjmrqz
诗人传记大全	shirenzhuanjidaquan	srzjdq
师士传说	shishichuanshuo	sscs
仕途异能传	shituyinengzhuan	stynz
石油地质学	shiyoudizhixue	sydzx
首都计划	shoudujihua	sdjh
书集传	shujichuan	sjc
书剑后传	shujianhouzhuan	sjhz
数据侠客行	shujuxiakexing	sjxkx
书目长编	shumuchangbian	smcb
水地	shuidi	sd
水浒后传	shuihuhouzhuan	shhz
水浒传	shuihuzhuan	shz
说呼全传	shuohuquanzhuan	shqz
说岳全传	shuoyuequanzhuan	syqz
四分律行事钞	sifenlvxingshichao	sflxsc
四伊玛目传	siyimamuchuan	symmc
宋高僧传	songgaosengchuan	sgsc
宋元本行格表	songyuanbenhanggebiao	sybhgb
宿根花卉	sugenhuahui	sghh
苏联经验重探	sulianjingyanzhongtan	sljyzt
苏联水文地理	sulianshuiwendili	slswdl
宿命战记	sumingzhanji	smzj
苏氏易传	sushiyizhuan	ssyz
苏悉地经	suxidijing	sxdj
宿曜经	suyaojing	syj
随县曾侯乙墓	suixianzenghouyimu	sxzhym
笋瓜自传	sunguazizhuan	sgzz
太空飞行	taikongfeixing	tkfx
太空飞行史	taikongfeixingshi	tkfxs
台湾宗教调查	taiwanzongjiaodiaocha	twzjdc
弹性地基梁	tanxingdijiliang	txdjl
唐长安大明宫	tangchangandaminggong	tcadmg
唐朝好男人	tangchaohaonanren	tchnr
唐高僧传	tanggaosengchuan	tgsc
天传世古诗	tianchuanshigushi	tcsgs
天地之间	tiandizhijian	tdzj
天国女殇别传	tianguonvshangbiezhuan	tgnsbz
田家五行	tianjiawuxing	tjwx
天降骄仆	tianjiangjiaopu	tjjp
天降神妻	tianjiangshenqi	tjsq
天使之行	tianshizhixing	tszx
天台九祖传	tiantaijiuzuchuan	ttjzc
天体运行论	tiantiyunxinglun	ttyxl
调教初唐	tiaojiaochutang	tjct
调教韩国	tiaojiaohanguo	tjhg
调教警花母亲	tiaojiaojinghuamuqin	tjjhmq
调教太子妃	tiaojiaotaizifei	tjtzf
听觉的试验	tingjuedeshiyan	tjdsy
同调代数	tongdiaodaishu	tdds
统计遗传学	tongjiyichuanxue	tjycx
通鉴地理通释	tongjiandilitongshi	tjdlts
通论地理学	tonglundilixue	tldlx
童声传媒	tongshengchuanmei	tscm
土地问题	tudiwenti	tdwt
图书馆行政	tushuguanxingzheng	tsgxz
彖传	tuanchuan	tc
瓦斯工奇遇	wasigongqiyu	wsgqy
宛妃传	wanfeizhuan	wfz
玩命奇人	wanmingqiren	wmqr
望都汉墓壁画	wangduhanmubihua	wdhmbh
妄尽还源观	wangjinhaiyuanguan	wjhyg
忘忧清乐集	wangyouqingleji	wyqlj
网游之天地	wangyouzhitiandi	wyztd
王震传奇	wangzhenchuanqi	wzcq
王子银传	wangziyinchuan	wzyc
魏晋南北朝史	weijinnanbeichaoshi	wjnbcs
维卡亚教法	weikayajiaofa	wkyjf
魏阉全传	weiyanquanzhuan	wyqz
我爱辣妹外传	woailameiwaizhuan	walmwz
握奇经	woqijing	wqj
我是传奇	woshichuanqi	wscq
吴都法乘	wudoufacheng	wdfc
无忌传人	wujichuanren	wjcr
武林外传	wulinwaizhuan	wlwz
五美缘全传	wumeiyuanquanzhuan	wmyqz
乌吾斯传	wuwusichuan	wwsc
五行剑传奇	wuxingjianchuanqi	wxjcq
五行志	wuxingzhi	wxz
西洋朝贡典录	xiyangchaogongdianlu	xycgdl
西游记传奇	xiyoujichuanqi	xyjcq
西游记后传	xiyoujihouzhuan	xyjhz
西域行传	xiyuxingchuan	xyxc
西藏地貌	xizangdimao	xzdm
西藏自然地理	xizangzirandili	xzzrdl
侠义风月传	xiayifengyuechuan	xyfyc
仙卜奇缘	xianbuqiyuan	xbqy
现代奇门遁甲	xiandaiqimendunjia	xdqmdj
现代奇人	xiandaiqiren	xdqr
现代艳帝传奇	xiandaiyandichuanqi	xdydcq
现代异能传奇	xiandaiyinengchuanqi	xdyncq
现代自然地理	xiandaizirandili	xdzrdl
仙石奇缘	xianshiqiyuan	xsqy
象传	xiangchuan	xc
相奸传说	xiangjianchuanshuo	xjcs
小兵传奇	xiaobingchuanqi	xbcq
小地貌学原理	xiaodimaoxueyuanli	xdmxyl
小亨传说	xiaohengchuanshuo	xhcs
萧红传	xiaohongchuan	xhc
小楼传说	xiaolouchuanshuo	xlcs
小屯南地甲骨	xiaotunnandijiagu	xtndjg
逍行纪	xiaoxingji	xxj
逍遥圣战传说	xiaoyaoshengzhanchuanshuo	xyszcs
校园六人行	xiaoyuanliurenxing	xylrx
校园奇侠	xiaoyuanqixia	xyqx
校园强暴秘录	xiaoyuanqiangbaomilu	xyqbml
校园雾都	xiaoyuanwudu	xywd
啸月传奇	xiaoyuechuanqi	xycq
邪帝苍龙传	xiedicanglongchuan	xdclc
邪神传说	xieshenchuanshuo	xscs
新雕英雄传	xindiaoyingxiongzhuan	xdyxz
新疆地貌	xinjiangdimao	xjdm
新九灭重生	xinjiumiechongsheng	xjmcs
心理学与遗传	xinlixueyuyichuan	xlxyyc
信士传	xinshichuan	xsc
信士修行之道	xinshixiuxingzhidao	xsxxzd
信息传输	xinxichuanshu	xxcs
新仙剑奇侠传	xinxianjianqixiazhuan	xxjqxz
新续高僧传	xinxugaosengchuan	xxgsc
性爱调教园	xingaitiaojiaoyuan	xatjy
行的道理	xingdedaoli	xddl
星际航行概论	xingjihangxinggailun	xjhxgl
兴起行经	xingqixingjing	xqxj
醒世姻缘传	xingshiyinyuanzhuan	xsyyz
行为的原理	xingweideyuanli	xwdyl
行为指南	xingweizhinan	xwzn
行销学	xingxiaoxue	xxx
行星际飞行	xingxingjifeixing	xxjfx
星英传	xingyingchuan	xyc
行政法	xingzhengfa	xzf
行政国家	xingzhengguojia	xzgj
行政基础	xingzhengjichu	xzjc
行政生态学	xingzhengshengtaixue	xzstx
行政行为	xingzhengxingwei	xzxw
行政学	xingzhengxue	xzx
行政学典范	xingzhengxuedianfan	xzxdf
行政学概论	xingzhengxuegailun	xzxgl
行政研究	xingzhengyanjiu	xzyj
兄妹失乐园	xiongmeishileyuan	xmsly
绣屏缘	xiupingyuan	xpy
修神传	xiushenchuan	xsc
修行本起经	xiuxingbenqijing	xxbqj
修行道地经	xiuxingdaodijing	xxddj
修真幻玄传	xiuzhenhuanxuanchuan	xzhxc
续高僧传	xugaosengchuan	xgsc
续济公传	xujigongzhuan	xjgz
虚空凝剑行	xukongningjianxing	xknjx
徐娘乐	xuniangle	xnl
玄幻奇幻	xuanhuanqihuan	xhqh
玄灵奇探	xuanlingqitan	xlqt
玄奘行传	xuanzangxingchuan	xzxc
血魅传奇	xuemeichuanqi	xmcq
雪山飞狐续传	xueshanfeihuxuchuan	xsfhxc
殉教者园地	xunjiaozheyuandi	xjzyd
寻美侠客行	xunmeixiakexing	xmxkx
延宝传灯录	yanbaochuandenglu	ybcdl
艳医修行录	yanyixiuxinglu	yyxxl
艳遇传说	yanyuchuanshuo	yycs
言语行为	yanyuxingwei	yyxw
杨家将外传	yangjiajiangwaizhuan	yjjwz
药地炮庄	yaodipaozhuang	ydpz
瑶华传	yaohuachuan	yhc
妖皇传说	yaohuangchuanshuo	yhcs
夜叉明王传	yechamingwangchuan	ycmwc
伊川易传	yichuanyizhuan	ycyz
依达耶提传	yidayetichuan	ydytc
一贯别传	yiguanbiezhuan	ygbz
依后传奇	yihouzhuanqi	yhzq
异界侠客行	yijiexiakexing	yjxkx
异世帝王行	yishidiwangxing	ysdwx
医学正传	yixuezhengzhuan	yxzz
医院奇遇记	yiyuanqiyuji	yyqyj
易传	yizhuan	yz
银河英雄传说	yinheyingxiongchuanshuo	yhyxcs
银河英雄传	yinheyingxiongzhuan	yhyxz
淫魔圣王传	yinmoshengwangchuan	ymswc
淫贼网游行	yinzeiwangyouxing	yzwyx
鹰刀传说	yingdaochuanshuo	ydcs
鹰狼传	yinglangchuan	ylc
鹰翔长空	yingxiangchangkong	yxck
英云梦传	yingyunmengchuan	yymc
永不独行	yongbuduxing	ybdx
永觉和尚广录	yongjueheshangguanglu	yjhsgl
永乐大典	yongledadian	yldd
永乐五年敕谕	yonglewunianchiyu	ylwncy
有机地球化学	youjidiqiuhuaxue	yjdqhx
油矿地球物理	youkuangdiqiuwuli	ykdqwl
游龙传	youlongchuan	ylc
有翼导弹引论	youyidaodanyinlun	yyddyl
欲海奇侠	yuhaiqixia	yhqx
瑜伽师地论	yujiashidilun	yjsdl
娱乐韩国	yulehanguo	ylhg
玉麟传奇	yulinchuanqi	ylcq
玉麟传说	yulinchuanshuo	ylcs
育强系列	yuqiangxilie	yqxl
原道觉世训	yuandaojueshixun	ydjsx
圆觉经	yuanjuejing	yjj
原强	yuanqiang	yq
元素地球化学	yuansudiqiuhuaxue	ysdqhx
岳飞传	yuefeizhuan	yfz
乐府集成	yuefujicheng	yfjc
乐府诗集	yuefushiji	yfsj
悦乐学园	yuelexueyuan	ylxy
葬地玄经	zangdixuanjing	zdxj
造神传说	zaoshenchuanshuo	zscs
造物奇迹	zaowuqiji	zwqj
曾文正公家书	zengwenzhenggongjiashu	zwzgjs
曾文正公全集	zengwenzhenggongquanji	zwzgqj
增长的极限	zengzhangdejixian	zzdjx
宅男重生	zhainanchongsheng	zncs
战地军妓	zhandijunji	zdjj
张峰外传	zhangfengwaizhuan	zfwz
长老偈	zhanglaoji	zlj
长老尼偈	zhanglaoniji	zlnj
折疑论	zheyilun	zyl
折翼天使	zheyitianshi	zyts
折狱龟鉴	zheyuguijian	zygj
折在信纸里	zhezaixinzhili	zzxzl
折纸游戏	zhezhiyouxi	zzyx
真言传	zhenyanchuan	zyc
征服神奇女侠	zhengfushenqinvxia	zfsqnx
郑观应传	zhengguanyingchuan	zgyc
政治与行政	zhengzhiyuxingzheng	zzyxz
知觉现象学	zhijuexianxiangxue	zjxxx
知觉与经验	zhijueyujingyan	zjyjy
直觉主义导论	zhijuezhuyidaolun	zjzydl
直觉主义原理	zhijuezhuyiyuanli	zjzyyl
知识的传授	zhishidechuanshou	zsdcs
植物地理学	zhiwudilixue	zwdlx
知行合一新论	zhixingheyixinlun	zxhyxl
只有一个地球	zhiyouyigediqiu	zyygdq
至尊觉醒	zhizunjuexing	zzjx
中国历朝美女	zhongguolichaomeinv	zglcmn
中华无敌前传	zhonghuawudiqianzhuan	zhwdqz
重活	zhonghuo	zh
重己	zhongji	zj
重辑渔洋书跋	zhongjiyuyangshuba	zjyysb
重金属外壳	zhongjinshuwaike	zjswk
众神传说	zhongshenchuanshuo	zscs
重生成树	zhongshengchengshu	zscs
重罪	zhongzui	zz
周朝秘史	zhouchaomishi	zcms
周易程氏传	zhouyichengshichuan	zycsc
周易大传	zhouyidazhuan	zydz
周易内传	zhouyineizhuan	zynz
周易外传	zhouyiwaizhuan	zywz
诸法无行经	zhufawuxingjing	zfwxj
诸天传	zhutianchuan	ztc
朱元璋传	zhuyuanzhangchuan	zyzc
缁门崇行录	zimenchongxinglu	zmcxl
总裁的圈套	zongcaidequantao	zcdqt
纵情都市	zongqingdushi	zqds
走进迦南地	zoujinjianandi	zjjnd
醉爱长笛	zuiaichangdi	zacd
左传	zuozhuan	zz
左传纪事本末	zuozhuanjishibenmo	zzjsbm
阿合奇县	aheqixian	ahqx
安徽省	anhuisheng	ahs
八宿县	basuxian	bsx
博乐市	boleshi	bls
长春市	changchunshi	ccs
长岛县	changdaoxian	cdx
昌都县	changduxian	cdx
长丰县	changfengxian	cfx
长葛市	changgeshi	cgs
长海县	changhaixian	chx
长乐市	changleshi	cls
昌乐县	changlexian	clx
长岭县	changlingxian	clx
长宁区	changningqu	cnq
长宁县	changningxian	cnx
长沙市	changshashi	css
长沙县	changshaxian	csx
长寿区	changshouqu	csq
长顺县	changshunxian	csx
长泰县	changtaixian	ctx
长汀县	changtingxian	ctx
长武县	changwuxian	cwx
长兴县	changxingxian	cxx
长垣县	changyuanxian	cyx
长治市	changzhishi	czs
长治县	changzhixian	czx
朝阳区	chaoyangqu	cyq
朝阳市	chaoyangshi	cys
朝阳县	chaoyangxian	cyx
成都市	chengdushi	cds
重庆	chongqing	cq
重庆市	chongqingshi	cqs
弹丸礁	danwanjiao	dwj
调兵山市	diaobingshanshi	dbss
都昌县	duchangxian	dcx
都江堰市	dujiangyanshi	djys
都兰县	dulanxian	dlx
都匀市	duyunshi	dys
丰都县	fengduxian	fdx
福建省	fujiansheng	fjs
甘肃省	gansusheng	gss
贡觉县	gongjuexian	gjx
广东省	guangdongsheng	gds
贵州省	guizhousheng	gzs
海南省	hainansheng	hns
河北省	hebeisheng	hbs
河南省	henansheng	hns
黑龙江省	heilongjiangsheng	hljs
湖北省	hubeisheng	hbs
湖南省	hunansheng	hns
吉林省	jilinsheng	jls
江都市	jiangdushi	jds
将乐县	jianglexian	jlx
江苏省	jiangsusheng	jss
江西省	jiangxisheng	jxs
锦屏县	jinpingxian	jpx
静乐县	jinglexian	jlx
康乐县	kanglexian	klx
浪卡子县	langkazixian	lkzx
乐亭县	laotingxian	ltx
乐安县	leanxian	lax
乐昌市	lechangshi	lcs
乐都县	leduxian	ldx
乐陵市	lelingshi	lls
乐平市	lepingshi	lps
乐山市	leshanshi	lss
乐业县	leyexian	lyx
乐至县	lezhixian	lzx
闵行区	minhangqu	mhq
民乐县	minlexian	mlx
墨竹工卡县	mozhugongkaxian	mzgkx
南乐县	nanlexian	nlx
宁都县	ningduxian	ndx
宁强县	ningqiangxian	nqx
屏东市	pingdongshi	pds
屏东县	pingdongxian	pdx
平乐县	pinglexian	plx
屏南县	pingnanxian	pnx
屏山县	pingshanxian	psx
奇台县	qitaixian	qtx
青海省	qinghaisheng	qhs
山东省	shandongsheng	sds
陕西省	shanxisheng	sxs
山西省	shanxishengshanxisheng	sxssxs
商都县	shangduxian	sdx
石屏县	shipingxian	spx
四川省	sichuansheng	scs
宿迁市	suqianshi	sqs
宿松县	susongxian	ssx
宿州市	suzhoushisuzhoushi	szsszs
台湾省	taiwansheng	tws
天长市	tianchangshi	tcs
万盛区	wanshengqu	wsq
望都县	wangduxian	wdx
温宿县	wensuxian	wsx
武强县	wuqiangxian	wqx
新乐市	xinleshi	xls
行唐县	xingtangxian	xtx
延长县	yanchangxian	ycx
宜都市	yidushi	yds
于都县	yuduxian	ydx
乐清市	yueqingshi	yqs
云南省	yunnansheng	yns
枣强县	zaoqiangxian	zqx
长子县	zhangzixian	zzx
昭觉县	zhaojuexian	zjx
浙江省	zhejiangsheng	zjs
子长县	zichangxian	zcx
行大运	xingdayun	xdy
奥斯卡	aosika	ask
重写	chongxie	chx
卡罗	kaluo	kl
自省	zixing	zx
地上	dishang	dsh
三重	sanchong	sch
贡献率	gongxianlv	gxl
都有	douyou	dy
好觉	haojiao	hj
还没	haimei	hm
奇谋	qimou	qm
汉朝	hanchao	hch
长荣	changrong	chr
朝鲜半岛	chaoxianbandao	chxbd
善行	shanxing	shx
工长	gongchang	gch
计分卡	jifenka	jfk
露地	ludi	ld
正确地	zhengquede	zhqd
市盈率	shiyinglv	shyl
宿州	suzhou	szh
教育强	jiaoyuqiang	jyq
还能	haineng	hn
前行	qianxing	qx
行波	xingbo	xb
英雄传	yingxiongzhuan	yxzh
长江三角洲	changjiangsanjiaozhou	chjsjzh
长风	changfeng	chf
多重	duozhong/duochong	dzh/dch
收视率	shoushilv	shshl
重置	chongzhi	chzh
沙地	shadi	shd
之地	zhidi	zhd
中朝	zhongchao	zhch
知行合一	zhixingheyi	zhxhy
重入	chongru	chr
卡西欧	kaxiou	kxo
重获	chonghuo	chh
强者	qiangzhe	qzh
最长	zuichang	zch
弹炮	danpao	dp
省时省力	shengshishengli	shshshl
而行	erxing	ex
雪地	xuedi	xd
多长	duochang	dch
之都	zhidu	zhd
慢慢地	manmande	mmd
行舟	xingzhou	xzh
五重	wuchong	wch
韦尔奇	weierqi	weq
口腔粘膜	kouqiangnianmo	kqnm
万盛	wansheng	wsh
省长	shengzhang	shzh
强势	qiangshi	qsh
还乡	huanxiang	hx
水调歌头	shuidiaogetou	shdgt
新地	xindi	xd
长调	changdiao	chd
奇境	qijing	qj
卡鲁索	kalusuo	kls
长谈	changtan	cht
护士长	hushizhang	hshzh
显示屏	xianshiping	xshp
抗美援朝	kangmeiyuanchao	kmych
刘少奇	liushaoqi	lshq
超强	chaoqiang	chq
透光率	touguanglv	tgl
地缘关系	diyuanguanxi	dygx
降血糖	jiangxuetang	jxt
奇奇	qiqi	qq
行酒	xingjiu	xj
百重	baichong	bch
站长	zhanzhang	zhzh
十四行	shisihang	shsh
绕道而行	raodaoerxing	rdex
省级	shengji	shj
卡塔尔	kataer	kte
弹琴	tanqin	tq
省内	shengnei	shn
降血脂	jiangxuezhi	jxzh
甘地	gandi	gd
都要	douyao	dy
盛宣怀	shengxuanhuai	shxh
各省	gesheng	gsh
奇侠传	qixiazhuan	qxzh
哪行	naxing/nahang	nx/nh
行吟	xingyin	xy
长江上游	changjiangshangyou	chjshy
弹到	tandao	td
长春	changchun	chch
蓝调	landiao	ld
重整	chongzheng	chzh
医院院长	yiyuanyuanzhang	yyyzh
湿地	shidi	shd
天书奇谭	tianshuqitan	tshqt
传质	chuanzhi	chzh
建行	jianhang	jh
道奇	daoqi	dq
史地	shidi	shd
长清	changqing	chq
最强	zuiqiang	zq
七重	qichong	qch
长啸	changxiao	chx
行路	xinglu	xl
卡耐基	kanaiji	knj
长江下游	changjiangxiayou	chjxy
东北三省	dongbeisansheng	dbssh
地市级	dishiji	dshj
皮卡	pika	pk
管乐	guanyue	gy
重工	zhonggong	zhg
厂长	changzhang	chzh
维奇	weiqi	wq
还不	haibu	hb
品管圈	pinguanquan	pgq
长江源	changjiangyuan	chjy
客都	kedu	kd
都可以	doukeyi	dky
长过	changguo	chg
天伦之乐	tianlunzhile	tlzhl
磁卡	cika	ck
宅地	zhaidi	zhd
全传	quanzhuan	qzh
乐昌	lechang	lch
串行	chuanxing/chuanhang	chx/chh
强效	qiangxiao	qx
三都	sandu	sd
行长	hangzhang	hzh
琵琶行	pipaxing	ppx
天差地别	tianchadibie	tchdb
还在	haizai	hz
践行	jianxing	jx
都江堰市	dujiangyanshi	djysh
地心	dixin	dx
卡哇伊	kawayi	kwy
弹出来	tanchulai	tchl
地价	dijia	dj
无调	wudiao	wd
长治市	changzhishi	czhsh
东行	dongxing	dx
各省市	geshengshi	gshsh
还要	haiyao	hy
馆长	guanzhang	gzh
藏传佛教	zangchuanfojiao	zchfj
曾侯乙	zenghouyi	zhy
元朝	yuanchao	ych
二重	erchong	ech
保险费率	baoxianfeilv	bxfl
还怕	haipa	hp
重塑	chongsu	chs
招行	zhaohang	zhh
必争之地	bizhengzhidi	bzhzhd
重组股	chongzugu	chzg
长大衣	changdayi	chdy
笛卡尔	dikaer	dke
地坛	ditan	dt
高分辨率	gaofenbianlv	gfbl
乐神	leshen	lsh
格林卡	gelinka	glk
地块	dikuai	dk
地坪	diping	dp
歌行	gehang	gh
奇人	qiren	qr
也行	yexing	yx
都应	douying	dy
野调无腔	yediaowuqiang	ydwq
再传	zaizhuan	zzh
长发	changfa	chf
车行	chehang	chh
奇事	qishi	qsh
兜率	doulv	dl
重症	zhongzheng	zhzh
笃行	duxing	dx
都在	douzai	dz
都江堰	dujiangyan	djy
生物传感器	shengwuchuanganqi	shwchgq
白蛇传	baishezhuan	bshzh
退耕还林	tuigenghuanlin	tghl
任我行	renwoxing	rwx
勇敢地	yonggande	ygd
林地	lindi	ld
奇想	qixiang	qx
调水	diaoshui	dsh
城市地标	chengshidibiao	chshdb
月经不调	yuejingbutiao	yjbt
南水北调	nanshuibeidiao	nshbd
长大	zhangda	zhd
地级市	dijishi	djsh
地灵人杰	dilingrenjie	dlrj
人地	rendi	rd
超长	chaochang	chch
重拳出击	zhongquanchuji	zhqchj
都不能	doubuneng	dbn
奇女	qinv	qn
行在	xingzai	xz
重载	chongzai	chz
宋朝	songchao	sch
强县	qiangxian	qx
三人行	sanrenxing	srx
都是	doushi	dsh
强悍	qianghan	qh
盛京	shengjing	shj
重组	chongzu	chz
重返	chongfan	chf
万里行	wanlixing	wlx
奇情	qiqing	qq
清朝	qingchao	qch
检察长	jianchazhang	jchzh
店长	dianzhang	dzh
城市用地	chengshiyongdi	chshyd
调出来	diaochulai	dchl
地名	diming	dm
长不大	zhangbuda	zhbd
地火	dihuo	dh
旅游地	lvyoudi	lyd
长江流域	changjiangliuyu	chjly
乐了	lele	ll
长效	changxiao	chx
朝天	chaotian	cht
乐乐	lele	ll
三角地	sanjiaodi	sjd
目的地	mudidi	mdd
重说	chongshuo	chsh
哈士奇	hashiqi	hshq
奇门	qimen	qm
地黄	dihuang	dh
临朝	linchao	lch
势在必行	shizaibixing	shzbx
班组长	banzuzhang	bzzh
重温	chongwen	chw
调出	diaochu	dch
还有	haiyou	hy
朝天椒	chaotianjiao	chtj
古乐	guyue	gy
弦乐	xianyue	xy
还小	haixiao	hx
剑侠传	jianxiazhuan	jxzh
秦朝	qinchao	qch
圈住	quanzhu	qzh
宿命	suming	sm
会员卡	huiyuanka	hyk
省油	shengyou	shy
都应该	douyinggai	dyg
内调	neidiao	nd
乐从	lecong	lc
慎行	shenxing	shx
传感	chuangan	chg
能行	nengxing	nx
山长水阔	shanchangshuikuo	shchshk
重述	chongshu	chsh
悲伤地	beishangde	bshd
孙传芳	sunchuanfang	schf
奇瑞	qirui	qr
陈省身	chengxingshen	chxsh
华盛顿	huashengdun	hshd
重访	chongfang	chf
省区	shengqu	shq
奥卡姆	aokamu	akm
乐翻天	lefantian	lft
世界五百强	shijiewubaiqiang	sjwbq
强震	qiangzhen	qzh
智能卡	zhinengka	zhnk
托斯卡	tuosika	tsk
保留地	baoliudi	bld
调适	tiaoshi	tsh
局长	juzhang	jzh
天降	tianjiang	tj
地藏经	dizangjing	dzj
名人传	mingrenzhuan	mrzh
长恨歌	changhenge	chhg
远行	yuanxing	yx
文传	wenchuan	wch
调速器	tiaosuqi	tsq
贴贴乐	tietiele	ttl
前传	qianzhuan	qzh
调速	tiaosu	ts
地史学	dishixue	dshx
尊师重道	zunshizhongdao	zshzhd
长高	zhanggao	zhg
省直管	shengzhiguan	shzhg
张中行	zhangzhongxing	zhzhx
朝鲜语	chaoxianyu	chxy
朝北	chaobei	chb
卡特	kate	kt
调酒师	tiaojiushi	tjsh
折抵	zhedi	zhd
礼乐	liyue	ly
长豇豆	changjiangdou	chjd
偷着乐	touzhele	tzhl
公安局长	gonganjuzhang	gajzh
奇案	qian	qa
调色	tiaose	ts
智圆行方	zhiyuanxingfang	zyxf
乐业	leye	ly
似曾相识	sicengxiangshi	scxsh
曾仕强	zengshiqiang	zshq
打折	dazhe	dzh
保护地	baohudi	bhd
卡夫卡	kafuka	kfk
乐毅	yueyi	yy
两地	liangdi	ld
轮机长	lunjizhang	ljzh
觉世	jueshi	jsh
圈地	quandi	qd
传感器	chuanganqi	chgq
农地	nongdi	nd
戴高乐	daigaole	dgl
朝鲜	chaoxian	chx
一切都是	yiqiedoushi	yqdsh
一觉睡到天亮	yijiaoshuidaotianliang	yjshdtl
盐都	yandu	yd
起重	qizhong	qzh
地龙	dilong	dl
人地关系	rendiguanxi	rdgx
知足常乐	zhizuchangle	zhzchle
矿长	kuangzhang	kzh
都能	douneng	dn
银弹	yindan	yd
爱新觉罗	aixinjueluo	axjl
圈圈	quanquan	qq
还给	huangei	hg
弹孔	dankong	dk
敬业乐群	jingyelequn	jylq
岩石圈	yanshiquan	yshq
中乐	zhongyue	zhy
还我河山	huanwoheshan	hwhsh
唐朝	tangchao	tch
乐山	leshan	lsh
调音	tiaoyin	ty
降压	jiangya	jy
宿州市	suzhoushi	szhsh
卡斯特罗	kasiteluo	kstl
重构	chonggou	chg
汪曾祺	wangzengqi	wzq
都还	douhai	dh
用地	yongdi	yd
降血压	jiangxueya	jxy
铺地	pudi	pd
重振	chongzhen	chzh
博采众长	bocaizhongchang	bczhch
长江	changjiang	chj
省时	shengshi	shsh
农家乐	nongjiale	njl
发源地	fayuandi	fyd
奇书	qishu	qsh
长沙	changsha	chsh
一地	yidi	yd
史传	shichuan	shch
长胡子	changhuzi	chhz
省柴节煤灶	shengchaijiemeizao	shchjmz
源地	yuandi	yd
钱伟长	qianweichang	qwch
长虹	changhong	chh
朝花夕拾	zhaohuaxishi	zhhxsh
自调	zitiao	zt
情人卡	qingrenka	qrk
麻省理工学院	mashengligongxueyuan	mshlgxy
太行山	taihangshan	thsh
宿迁	suqian	sq
两圈	liangquan	lq
西方极乐	xifangjile	xfjl
可口可乐	kekoukele	kkkl
为重	weizhong	wzh
触摸屏	chumoping	chmp
克罗地亚	keluodiya	kldy
重装	chongzhuang	chzh
范长江	fanchangjiang	fchj
我行	woxing	wx
征地	zhengdi	zhd
曾国藩	zengguofan	zgf
资产重组	zichanchongzu	zchchz
地勘	dikan	dk
强韧	qiangren	qr
胶粘	jiaozhan	jzh
小强	xiaoqiang	xq
卡恩	kaen	ke
组长	zuzhang	zzh
奇功	qigong	qg
兵行诡道	bingxingguidao	bxgd
奇趣	qiqu	qq
极乐	jile	jl
合理地	helide	hld
卡位	kawei	kw
长青	changqing	chq
奥古斯都	aogusidu	agsd
之乐	zhile	zhl
强音	qiangyin	qy
调音师	tiaoyinshi	tysh
地电	didian	dd
地税	dishui	dsh
天朝	tianchao	tch
粘合剂	nianheji	nhj
部长	buzhang	bzh
上天入地	shangtianrudi	shtrd
盛衰	shengshuai	shsh
弹拨	tanbo	tb
长矛	changmao	chm
行天下	xingtianxia	xtx
农用地	nongyongdi	nyd
地缘政治学	diyuanzhengzhixue	dyzhzhx
性地	xingdi	xd
省钱	shengqian	shq
班长	banzhang	bzh
阿尔都塞	aerdusai	aeds
长距离	changjuli	chjl
随行	suixing	sx
长丝	changsi	chs
藏传	zangchuan	zch
四地	sidi	sd
还没有	haimeiyou	hmy
长毛兔	changmaotu	chmt
乐在其中	lezaiqizhong	lzqzh
地趟	ditang	dt
中行	zhonghang	zhh
还敢	haigan	hg
重建家园	chongjianjiayuan	chjjy
知行	zhixing	zhx
太行	taihang	th
折弯	zhewan	zhw
重现	chongxian	chx
长存	changcun	chc
领地	lingdi	ld
降脂	jiangzhi	jzh
市行	shihang	shh
经济圈	jingjiquan	jjq
后传	houzhuan	hzh
谁都	shuidou	shd
长拳	changquan	chq
长白山	changbaishan	chbsh
重走	chongzou	chz
客地	kedi	kd
抱怨地	baoyuandi	byd
九重	jiuchong	jch
重拾	chongshi	chsh
秦都区	qinduqu	qdq
长治	changzhi	chzh
还你	huanni	hn
商都	shangdu	shd
各行其道	gexingqidao	gxqd
奇志	qizhi	qzh
朝东	chaodong	chd
组织部长	zuzhibuzhang	zzhbzh
探奇	tanqi	tq
正传	zhengzhuan	zhzh
徐长卿	xuchangqing	xchq
长石	changshi	chsh
英烈传	yingliezhuan	ylzh
乐者	yuezhe	yzh
长椅	changyi	chy
卡斯特	kasite	kst
奇术	qishu	qsh
满地	mandi	md
降糖	jiangtang	jt
园长	yuanzhang	yzh
白传	baichuan	bch
强磁场	qiangcichang	qcch
省港	shenggang	shg
三重门	sanchongmen	schm
骑行	qixing	qx
长江中下游	changjiangzhongxiayou	chjzhxy
董事长	dongshizhang	dshzh
新传	xinzhuan	xzh
还我	huanwo	hw
乐群	lequn	lq
弧圈球	huquanqiu	hqq
传销	chuanxiao	chx
央行	yanghang	yh
长江口	changjiangkou	chjk
子长县	zichangxian	zchx
调账	tiaozhang	tzh
芬奇	fenqi	fq
秘传	michuan	mch
浩气长存	haoqichangcun	hqchc
调质	tiaozhi	tzh
地缘	diyuan	dy
可乐	kele	kl
盛唐	shengtang	sht
还会	haihui	hh
市长	shizhang	shzh
织田信长	zhitianxinchang	zhtxch
重建	chongjian	chj
知易行难	zhiyixingnan	zhyxn
省委书记	shengweishuji	shwshj
地角	dijiao	dj
片地	piandi	pd
长江大学	changjiangdaxue	chjdx
许地山	xudishan	xdsh
费率	feilv	fl
乐山市	leshanshi	lshsh
米奇	miqi	mq
昌都	changdu	chd
山高水长	shangaoshuichang	shgshch
山崩地裂	shanbengdilie	shbdl
菜地	caidi	cd
三行	sanhang	sh
粘结	nianjie	nj
南行	nanxing	nx
省委	shengwei	shw
学行	xuexing	xx
都想	douxiang	dx
奇景	qijing	qj
长青树	changqingshu	chqsh
刘铭传	liumingchuan	lmch
重中之重	zhongzhongzhizhong	zhzhzhzh
长阳	changyang	chy
成都	chengdu	chd
复调	fudiao	fd
家乐福	jialefu	jlf
红都	hongdu	hd
队长	duizhang	dzh
压力传感器	yalichuanganqi	ylchgq
卡尔	kaer	ke
笑传	xiaochuan	xch
重于	zhongyu	zhy
苦乐	kule	kl
还找	haizhao	hzh
县长	xianzhang	xzh
长流	changliu	chl
长三角	changsanjiao	chsj
粘性	nianxing	nx
调酒	tiaojiu	tj
长江三峡	changjiangsanxia	chjsx
之行	zhixing	zhx
浙江省	zhejiangsheng	zhjsh
安徽省	anhuisheng	ahsh
福建省	fujiansheng	fjsh
江西省	jiangxisheng	jxsh
山东省	shandongsheng	shdsh
河南省	henansheng	hnsh
湖北省	hubeisheng	hbsh
湖南省	hunansheng	hnsh
广东省	guangdongsheng	gdsh
海南省	hainansheng	hnsh
四川省	sichuansheng	schsh
河北省	hebeisheng	hbsh
贵州省	guizhousheng	gzhsh
山西省	shanxisheng	shxsh
云南省	yunnansheng	ynsh
辽宁省	liaoningsheng	lnsh
陕西省	shanxisheng	shxsh
吉林省	jilinsheng	jlsh
甘肃省	gansusheng	gssh
黑龙江省	heilongjiangsheng	hljsh
青海省	qinghaisheng	qhsh
江苏省	jiangsusheng	jssh
台湾省	taiwansheng	twsh
重庆	chongqing	chq
一字长蛇阵	yizichangshezhen	yzcsz
一席之地	yixizhidi	yxzd
一意孤行	yiyiguxing	yygx
一技之长	yijizhichang	yjzc
一朝一夕	yizhaoyixi	yzyx
一波三折	yibosanzhe	ybsz
一物降一物	yiwuxiangyiwu	ywxyw
一目十行	yimushihang	ymsh
一脉相传	yimaixiangchuan	ymxc
一行	yixing	yx
一败涂地	yibaitudi	ybtd
七十二行	qishierhang	qseh
万古长青	wanguchangqing	wgcq
三朝	sanzhao	sz
三百六十行	sanbailiushihang	sblsh
三长两短	sanchangliangduan	scld
上朝	shangchao	sc
上行	shangxing	sx
上行下效	shangxingxiaxiao	sxxx
上调	shangtiao	st
下地	xiadi	xd
下行	xiaxing	xx
下调	xiatiao	xt
下降	xiajiang	xj
不亦乐乎	buyilehu	bylh
不曾	buceng	bc
不毛之地	bumaozhidi	bmzd
不省人事	buxingrenshi	bxrs
不知天高地厚	buzhitiangaodihou	bztgdh
不管部长	buguanbuzhang	bgbz
不行	buxing	bx
不见经传	bujianjingzhuan	bjjz
不足为奇	buzuweiqi	bzwq
与世长辞	yushichangci	yscc
丑行	chouxing	cx
专长	zhuanchang	zc
世传	shichuan	sc
东三省	dongsansheng	dss
两重性	liangchongxing	lcx
严重	yanzhong	yz
中子弹	zhongzidan	zzd
丰盛	fengsheng	fs
举行	juxing	jx
举足轻重	juzuqingzhong	jzqz
举重	juzhong	jz
义地	yidi	yd
乐不可支	lebukezhi	lbkz
乐不思蜀	lebusishu	lbss
乐事	leshi	ls
乐于	leyu	ly
乐儿	ler	le
乐呵呵	lehehe	lhh
乐和	lehe	lh
乐善好施	leshanhaoshi	lshs
乐器	yueqi	yq
乐团	yuetuan	yt
乐园	leyuan	ly
乐土	letu	lt
乐坛	yuetan	yt
乐天	letian	lt
乐天知命	letianzhiming	ltzm
乐子	lezi	lz
乐师	yueshi	ys
乐府	yuefu	yf
乐律	yuelv	yl
乐得	lede	ld
乐意	leyi	ly
乐户	yuehu	yh
乐曲	yuequ	yq
乐极生悲	lejishengbei	ljsb
乐歌	yuege	yg
乐此不疲	lecibupi	lcbp
乐池	yuechi	yc
乐清	yueqing	yq
乐滋滋	lezizi	lzz
乐理	yueli	yl
乐章	yuezhang	yz
乐舞	yuewu	yw
乐观	leguan	lg
乐谱	yuepu	yp
乐趣	lequ	lq
乐队	yuedui	yd
乐陶陶	letaotao	ltt
乐音	yueyin	yy
乖觉	guaijue	gj
九重霄	jiuchongxiao	jcx
乞降	qixiang	qx
买椟还珠	maiduhuanzhu	mdhz
乱弹	luantan	lt
二十八宿	ershibaxiu	esbx
二地主	erdizhu	edz
二重性	erchongxing	ecx
亏折	kuishe	ks
五体投地	wutitoudi	wttd
五行	wuxing	wx
五行八作	wuhangbazuo	whbz
交响乐	jiaoxiangyue	jxy
交还	jiaohuan	jh
产地	chandi	cd
享乐	xiangle	xl
京都	jingdu	jd
亲传	qinchuan	qc
人地生疏	rendishengshu	rdss
人工降雨	rengongjiangyu	rgjy
人杰地灵	renjiediling	rjdl
人行横道	renxinghengdao	rxhd
人行道	renxingdao	rxd
人造地球卫星	renzaodiqiuweixing	rzdqwx
人造行星	renzaoxingxing	rzxx
今朝	jinzhao	jz
从长计议	congchangjiyi	ccjy
以讹传讹	yiechuane	yece
以还	yihuan	yh
任重道远	renzhongdaoyuan	rzdy
仿行	fangxing	fx
伏地	fudi	fd
众口难调	zhongkounantiao	zknt
传世	chuanshi	cs
传习	chuanxi	cx
传人	chuanren	cr
传代	chuandai	cd
传令	chuanling	cl
传入神经	chuanrushenjing	crsj
传写	chuanxie	cx
传出神经	chuanchushenjing	ccsj
传动	chuandong	cd
传动带	chuandongdai	cdd
传单	chuandan	cd
传告	chuangao	cg
传呼	chuanhu	ch
传呼电话	chuanhudianhua	chdh
传唤	chuanhuan	ch
传唱	chuanchang	cc
传声器	chuanshenqi	csq
传声筒	chuanshentong	cst
传奇	chuanqi	cq
传媒	chuanmei	cm
传宗接代	chuanzongjiedai	czjd
传家	chuanjia	cj
传家宝	chuanjiabao	cjb
传导	chuandao	cd
传布	chuanbu	cb
传情	chuanqing	cq
传戒	chuanjie	cj
传扬	chuanyang	cy
传承	chuancheng	cc
传抄	chuanchao	cc
传授	chuanshou	cs
传播	chuanbo	cb
传教	chuanjiao	cj
传教士	chuanjiaoshi	cjs
传本	chuanben	cb
传染	chuanran	cr
传染病	chuanranbing	crb
传檄	chuanxi	cx
传流	chuanliu	cl
传灯	chuandeng	cd
传略	zhuanlve	zl
传真	chuanzhen	cz
传神	chuanshen	cs
传票	chuanpiao	cp
传种	chuanzhong	cz
传粉	chuanfen	cf
传经	chuanjing	cj
传统	chuantong	ct
传艺	chuanyi	cy
传见	chuanjian	cj
传观	chuanguan	cg
传言	chuanyan	cy
传讯	chuanxun	cx
传记	zhuanji	zj
传译	chuanyi	cy
传话	chuanhua	ch
传语	chuanyu	cy
传说	chuanshuo	cs
传诵	chuansong	cs
传输	chuanshu	cs
传输线	chuanshuxian	csx
传达	chuanda	cd
传述	chuanshu	cs
传送	chuansong	cs
传送带	chuansongdai	csd
传递	chuandi	cd
传道	chuandao	cd
传闻	chuanwen	cw
传阅	chuanyue	cy
传颂	chuansong	cs
伯乐	bole	bl
伴宿	bansu	bs
位觉	weijue	wj
低调	didiao	dd
住地	zhudi	zd
住宿	zhusu	zs
体重	tizhong	tz
何乐而不为	heleerbuwei	hlebw
何曾	heceng	hc
余地	yudi	yd
作乐	zuole	zl
例行公事	lixinggongshi	lxgs
供求率	gongqiulv	gql
侧重	cezhong	cz
便宜行事	bianyixingshi	byxs
保外执行	baowaizhixing	bwzx
保重	baozhong	bz
信号弹	xinhaodan	xhd
信宿	xinsu	xs
信用卡	xinyongka	xyk
俭省	jiansheng	js
修行	xiuxing	xx
修长	xiuchang	xc
俱乐部	julebuclub	jlb
倍率	beiliv	b
倏地	shudi	sd
倒行逆施	daoxingnishi	dxns
倔强	juejiang	jj
倚重	yizhong	yz
借宿	jiesu	js
借尸还魂	jieshihuanhun	jshh
借调	jiediao	jd
借重	jiezhong	jz
偏重	pianzhong	pz
做圈套	zuoquantao	zqt
偿还	changhuan	ch
催泪弹	cuileidan	cld
兄长	xiongzhang	xz
先行	xianxing	xx
先行官	xianxingguan	xxg
先行者	xianxingzhe	xxz
先觉	xianjue	xj
光圈	guangquan	gq
兜圈子	douquanzi	dqz
全武行	quanwuhang	qwh
全盛	quansheng	qs
全都	quandou	qd
八行书	bahangshu	bhs
六朝	liuchao	lc
关卡	guanqia	gq
兴盛	xingsheng	xs
兵强马壮	bingqiangmazhuang	bqmz
养地	yangdi	yd
兽行	shouxing	sx
内传	neizhuan	nz
内地	neidi	nd
内省	neixing	nx
内行	neihang	nh
冗长	rongchang	rc
军乐	junyue	jy
军事基地	junshijidi	jsjd
冰天雪地	bingtianxuedi	btxd
净重	jingzhong	jz
凝固汽油弹	ningguqiyoudanc	ngqyd
凝重	ningzhong	nz
几曾	jiceng	jc
几率	jilv	jl
出人头地	churentoudi	crtd
出圈	chujuan	cj
出圈儿	chuquanr	cqe
出奇	chuqi	cq
出奇制胜	chuqizhisheng	cqzs
出生率	chushenglv	csl
出行	chuxing	cx
分厘卡	fenlika	flk
刊行	kanxing	kx
列传	liezhuan	lz
列强	lieqiang	lq
刚强	gangqiang	gq
利率	lilv	ll
别传	biezhuan	bz
别无长物	biewuchangwuzhang	bwzw
别有天地	bieyoutiandi	bytd
刮地皮	guadipi	gdp
割地	gedi	gd
力行	lixing	lx
劝降	quanxiang	qx
功率	gonglv	gl
加农榴弹炮	jianongliudanpao	jnldp
加强	jiaqiang	jq
加重	jiazhong	jz
动弹	dongtn	d
助长	zhuzhang	zz
劳动强度	laodongqiandu	ldd
劳动生产率	laodongshengchanlv	ldscl
勉强	mianqiang	mq
包围圈	baoweiquan	bwq
北朝	beichao	bc
匝地	zadi	zd
十四行诗	shisihangshi	sshs
十番乐	shifanyue	sfy
千卡	qianka	qk
千奇百怪	qianqibaiguai	qqbg
千粒重	qianlizhong	qlz
千里之行	qianlizhixing	qlzx
升降	shengjiang	sj
升降机	shengjiangji	sjj
升降舵	shengjiangduo	sjd
午觉	wujiao	wj
半殖民地	banzhimindi	bzmd
协调	xietiao	xt
单传	danchuan	dc
单行	danxing	dx
单行本	danxingben	dxb
单行线	danxingxian	dxx
单调	dandiao	dd
南北朝	nanbeichao	nbc
南朝	nanchao	nc
南腔北调	nanqiangbeidiao	nqbd
博闻强识	bowenqiangzhi	bwqs
卡介苗	kajiemiao	kjm
卡其	kaqi	kq
卡具	qiaju	qj
卡壳	qiake	qq
卡子	qiazi	qz
卡宾枪	kabinqiang	kbq
卡尺	kachi	kc
卡带	kadai	kd
卡拉ok	kalaouk	klok
卡片	kapian	kp
卡特尔	kateer	kte
卡脖子	qiabozi	qbz
卡规	kagui	kg
卡路里	kalulicalorie	kll
卡车	kache	kc
卡通	katong	kt
卡钳	kaqian	kq
印行	yinxing	yx
危重	weizhong	wz
卷土重来	juantuchonglai	jtcl
历朝	lichao	lc
厉行	lixing	lx
压强	yaqiang	yq
原子弹	yuanzidan	yzd
原线圈	yuanxianquan	yxq
双重	shuangchong	sc
双重人格	shuangchongrenge	scrg
双重国籍	shuangchongguoji	scgj
反其道而行之	fanqidaoerxingzhi	fqdexz
反弹	fantan	ft
反省	fanxing	fx
反调	fandiao	fd
发人深省	farenshenxing	frsx
发卡	faqia	fq
发祥地	faxiangdi	fxd
发行	fahangfa	fh
发觉	fajue	fj
发还	fahuan	fh
取乐	qule	ql
取长补短	quchangbuduan	qcbd
受降	shouxiang	sx
变调	biandiao	bd
口传	kouchuan	kc
口重	kouzhong	kz
古都	gudu	gd
可卡因	kekayinchoncocaine	kky
可行	kexing	kx
台地	taidi	td
司务长	siwuzhang	swz
长一智	zhangyizhi	zyz
吃重	chizhong	cz
吃长斋	chichangzhai	ccz
各行其是	gexingqishi	gxqs
同行	tonghang	th
同调	tongdiao	td
名不虚传	mingbuxuchuan	mbxc
名宿	mingsu	ms
后行	houxing	hx
听觉	tingjue	tj
吹奏乐	chuizouyue	czy
告地状	gaodizhuang	gdz
周折	zhouzhe	zz
呱呱坠地	guguzhuidi	ggzd
味觉	weijue	wj
呼天抢地	hutianqiangdi	htqd
和乐	hele	hl
咏叹调	yongtandiao	ytd
哀乐	aiyue	ay
品行	pinxing	px
哄传	hongchuan	hc
响遏行云	xiangexingyun	xexy
哨卡	shaoqia	sq
唱反调	changfandiao	cfd
唱高调	changgaodiao	cgd
商行	shanghang	sh
喜乐	xile	xl
喜闻乐见	xiwenlejian	xwlj
嗅觉	xiujue	xj
嘉言懿行	jiayanyixing	jyyx
嘎调	gadiao	gd
器乐	qiyue	qy
器重	qizhong	qz
回还	huihuan	hh
因地制宜	yindizhiyi	ydzy
囫囵觉	hulunjiaoxiu	hlj
园地	yuandi	yd
困觉	kunjiao	kj
围屏	weiping	wp
固定汇率	gudinghuilv	gdhl
国乐	guoyue	gy
国都	guodu	gd
圆周率	yuanzhoulv	yzl
圆圈	yuanquan	yq
圈养	juanyang	jy
圈套	quantao	qt
圈子	quanzi	qz
圈定	quanding	qd
圈拢	quanlong	ql
圈椅	quanyi	qy
圈点	quandian	qd
圈肥	juanfei	jf
圈阅	quanyue	qy
土地	tudi	td
土地改革	tudigaige	tdgg
土地革命战争	tudigemingzhanzheng	tdgmzz
土生土长	tushengtuzhang	tstz
圣地	shengdi	sd
圣经贤传	shengjingxianzhuan	sjxz
圣诞卡	shengdanka	sdk
在行	zaihang	zh
地上茎	dishangjing	dsj
地下	dixia	dx
地下室	dixiashi	dxs
地下水	dixiashui	dxs
地下茎	dixiajing	dxj
地下铁道	dixiatiedao	dxtd
地主	dizhu	dz
地产	dichan	dc
地亩	dimu	dm
地位	diwei	dw
地保	dibao	db
地儿	dir	de
地利	dili	dl
地力	dili	dl
地动	didong	dd
地动仪	didongyi	ddy
地势	dishi	ds
地勤	diqin	dq
地区	diqu	dq
地图	ditu	dt
地址	dizhi	dz
地垄	dilong	dl
地埂	digeng	dg
地域	diyu	dy
地基	diji	dj
地堡	dibao	db
地壳	diqiao	dq
地大物博	didawubo	ddwb
地头	ditou	dt
地头蛇	ditoushe	dts
地契	diqi	dq
地学	dixue	dx
地宫	digong	dg
地层	diceng	dc
地峡	dixia	dx
地带	didai	dd
地幔	diman	dm
地平线	dipingxian	dpx
地府	difu	df
地形	dixing	dx
地形图	dixingtu	dxt
地心引力	dixinyinli	dxyl
地心说	dixinshuo	dxs
地摊	ditan	dt
地支	dizhi	dz
地政	dizheng	dz
地方	difang	df
地方主义	difangzhuyi	dfzy
地方志	difangzhi	dfz
地方性植物	difangxingzhiwu	dfxzw
地方戏	difangxi	dfx
地方时	difangshi	dfs
地方民族主义	difangminzuzhuyi	dfmzzy
地方病	difangbing	dfb
地方税	difangshui	dfs
地权	diquan	dq
地板	diban	db
地极	diji	dj
地栗	dili	dl
地核	dihe	dh
地根儿	digenr	dge
地梨	dili	dl
地步	dibu	db
地段	diduan	dd
地毯	ditan	dt
地沟	digou	dg
地波	dibo	db
地洞	didong	dd
地温	diwen	dw
地漏	dilou	dl
地潮	dichao	dc
地点	didian	dd
地热	dire	dr
地煞	disha	ds
地牢	dilao	dl
地物	diwu	dw
地狱	diyu	dy
地球	diqiu	dq
地球仪	diqiuyi	dqy
地理	dili	dl
地理学	dilixue	dlx
地瓜	digua	dg
地界	dijie	dj
地痞	dipi	dp
地皮	dipi	dp
地盘	dipan	dp
地磁	dici	dc
地磁极	diciji	dcj
地磅	dibang	db
地租	dizu	dz
地秤	dicheng	dc
地积	diji	dj
地窖	dijiao	dj
地窨子	diyinzi	dyz
地线	dixian	dx
地老天荒	dilaotianhuang	dlth
地脉	dimai	dm
地脚	dijiao	dj
地脚螺丝	dijiaoluosi	djls
地膜	dimo	dm
地菍	dinie	dn
地衣	diyi	dy
地表	dibiao	db
地覆天翻	difutianfan	dftf
地貌	dimao	dm
地财	dicai	dc
地质	dizhi	dz
地质学	dizhixue	dzx
地质年代	dizhiniandai	dznd
地轴	dizhou	dz
地道	didao	dd
地邻	dilin	dl
地铁	ditie	dt
地铺	dipu	dp
地雷	dilei	dl
地震	dizhen	dz
地震波	dizhenbo	dzb
地震烈度	dizhenliedu	dzld
地震震级	dizhenzhenji	dzzj
地面	dimian	dm
地鳖	dibie	db
地黄牛	dihuangniu	dhn
地	dibu	d
场地	changdi	cd
坐地	zuodi	zd
坐地分赃	zuodifenzang	zdfz
坚强	jianqiang	jq
坟地	fendi	fd
坠地	zhuidi	zd
坡地	podi	pd
坦率	tanshuai	ts
垫圈	dianjuan	dj
基地	jidi	jd
基调	jidiao	jd
境地	jingdi	jd
墓地	mudi	md
增强	zengqiang	zq
增长	zengzhang	zz
声乐	shengyue	sy
声调	shengdiao	sd
处女地	chunvdi	cnd
外传	waichuan	wc
外地	waidi	wd
外强中干	waiqiangzhonggan	wqzg
外省	waisheng	ws
外行	waihang	wh
外调	waidiao	wd
外长	waizhang	wz
夜长梦多	yechangmengduo	ycmd
大卡	daka	dk
大地	dadi	dd
大排行	dapaihang	dph
大率	dashuai	ds
大行星	daxingxing	dxx
天公地道	tiangongdidao	tgdd
天南地北	tiannandibei	tndb
天地	tiandi	td
天崩地裂	tianbengdilie	tbdl
天差地远	tianchadiyuan	tcdy
天悬地隔	tianxuandige	txdg
天旋地转	tianxuandizhuan	txdz
天昏地暗	tianhundian	thda
天经地义	tianjingdiyi	tjdy
天罗地网	tianluodiwang	tldw
天翻地覆	tianfandifu	tfdf
天荒地老	tianhuangdilao	thdl
天诛地灭	tianzhudimie	tzdm
天造地设	tianzaodishe	tzds
天长地久	tianchangdijiu	tcdj
天长日久	tianchangrijiu	tcrj
天马行空	tianmaxingkong	tmxk
天高地厚	tiangaodihou	tgdh
太阳地儿	taiyangdir	tyde
夭折	yaozhe	yz
失传	shichuan	sc
失地	shidi	sd
失调	shitiao	st
失重	shizhong	sz
头重脚轻	touzhongjiaoqing	tzjq
奇伟	qiwei	qw
奇兵	qibing	qb
奇勋	qixun	qx
奇妙	qimiao	qm
奇峰	qifeng	qf
奇崛	qijue	qj
奇巧	qiqiao	qq
奇幻	qihuan	qh
奇异	qiyi	qy
奇形怪状	qixingguaizhuang	qxgz
奇怪	qiguai	qg
奇才	qicai	qc
奇拔	qiba	qb
奇效	qixiao	qx
奇数	jishu	js
奇文共赏	qiwengongshang	qwgs
奇特	qite	qt
奇耻大辱	qichidaru	qcdr
奇葩	qipa	qp
奇袭	qixi	qx
奇装异服	qizhuangyifu	qzyf
奇观	qiguan	qg
奇谈	qitan	qt
奇货可居	qihuokeju	qhkj
奇迹	qiji	qj
奇遇	qiyu	qy
奇闻	qiwen	qw
奇零	jiling	jl
奉行	fengxing	fx
奉还	fenghuan	fh
奋发图强	fenfatuqiang	fftq
奏乐	zouyue	zy
奏折	zouzhe	zz
奠都	diandu	dd
好善乐施	haoshanleshi	hsls
好奇	haoqi	hq
好强	haoqiang	hq
如释重负	rushizhongfu	rszf
娱乐	yule	yl
嫡传	dichuan	dc
子弹	zidan	zd
子母弹	zimudan	zmd
字调	zidiao	zd
字里行间	zilihangjian	zlhj
存折	cunzhe	cz
孤行	guxing	gx
学长	xuezhang	xz
安乐	anle	al
安乐死	anlesi	als
安乐窝	anlewo	alw
安土重迁	antuzhongqian	atzq
安居乐业	anjuleye	ajly
安贫乐道	anpinledao	apld
官长	guanzhang	gz
定时炸弹	dingshizhadan	dszd
定都	dingdu	dd
宝地	baodi	bd
宝重	baozhong	bz
实地	shidi	sd
实弹	shidan	sd
实行	shixing	sx
宣传	xuanchuan	xc
宣传品	xuanchuanpin	xcp
宣传弹	xuanchuandan	xcd
宣传画	xuanchuanhua	xch
宣叙调	xuanxudiao	xxd
室内乐	shineiyue	sny
宫调	gongdiao	gd
家长	jiazhang	jz
家长制	jiazhangzhi	jzz
家长里短	jiachangliduan	jcld
容重	rongzhong	rz
宿世	sushi	ss
宿主	suzhu	sz
宿仇	suchou	sc
宿债	suzhai	sz
宿儒	suru	sr
宿命论	suminglun	sml
宿土	sutu	st
宿娼	suchang	sc
宿将	sujiang	sj
宿弊	subi	sb
宿志	suzhi	sz
宿怨	suyuan	sy
宿愿	suyuan	sy
宿敌	sudi	sd
宿根	sugen	sg
宿疾	suji	sj
宿舍	sushe	ss
宿营	suying	sy
宿诺	sunuo	sn
宿逋	subu	sb
寄宿	jisu	js
寄宿生	jisusheng	jss
富强	fuqiang	fq
察觉	chajue	cj
寸步难行	cunbunanxing	cbnx
对折	duizhe	dz
对牛弹琴	duiniutanqin	dntq
对调	duidiao	dd
导弹	daodan	dd
封地	fengdi	fd
尊重	zunzhong	zz
尊长	zunzhang	zz
小传	xiaozhuan	xz
小圈子	xiaoquanzi	xqz
小行星	xiaoxingxing	xxx
小调	xiaodiao	xd
就地	jiudi	jd
尺短寸长	chiduancunchang	cdcc
居奇	juqi	jq
屈折语	quzheyu	qzy
屏幕	pingmu	pm
屏息	bingxi	bx
屏条	pingtiao	pt
屏气	bingqi	bq
屏蔽	pingbi	pb
屏藩	pingfan	pf
屏迹	bingji	bj
屏退	bingtui	bt
屏门	pingmen	pm
屏除	bingchubin	bc
屏障	pingzhang	pz
屏风	pingfeng	pf
属地	shudi	sd
履行	lvxing	lx
山地	shandi	sd
岗卡	gangqia	gq
岗地	gangdi	gd
川地	chuandi	cd
巡行	xunxing	xx
工地	gongdi	gd
差强人意	chaqiangrenyi	cqry
巴巴儿地	babarde	bbed
师长	shizhang	sz
希奇	xiqi	xq
帕斯卡	pasikablaisepascal	psk
席地	xidi	xd
常行军	changxingjun	cxj
平地	pingdi	pd
平地一声雷	pingdiyishenglei	pdysl
平地楼台	pingdiloutai	pdlt
平地风波	pingdifengbo	pdfb
平行	pingxing	px
平行作业	pingxingzuoye	pxzy
平行四边形	pingxingsibianxing	pxsbx
平行线	pingxingxian	pxx
平衡觉	pinghengjue	phj
年富力强	nianfuliqiang	nflq
并行	bingxing	bx
并行不悖	bingxingbubei	bxbb
并重	bingzhong	bz
幸灾乐祸	xingzailehuo	xzlh
幻觉	huanjue	hj
广东音乐	guangdongyinyue	gdyy
庄稼地	zhuangjiadi	zjd
庄重	zhuangzhong	zz
康乐	kangle	kl
康乐球	kangleqiu	klq
延长	yanchang	yc
建都	jiandu	jd
开天辟地	kaitianpidi	ktpd
开花弹	kaihuadan	khd
开行	kaixing	kx
开阔地	kaikuodi	kkd
异地	yidi	yd
弦乐器	xianyueqi	xyq
弱肉强食	ruorouqiangshi	rrqs
弹丸	danwan	dw
弹冠相庆	tanguanxiangqing	tgxq
弹力	tanli	tl
弹劾	tanhe	th
弹压	tanya	ty
弹唱	tanchang	tc
弹坑	dankeng	dk
弹壳	danke	dq
弹头	dantou	dt
弹子	danzit	dz
弹子锁	danzisuo	dzs
弹射	tanshe	ts
弹弓	dangongtan	dg
弹性	tanxing	tx
弹拨乐器	tanboyueqi	tblq
弹指	tanzhi	tz
弹泪	tanlei	tl
弹片	danpian	dp
弹痕	danhen	dh
弹着点	danzhuodian	dzd
弹簧	tanhuang	th
弹簧秤	tanhuangcheng	thc
弹簧门	tanhuangmen	thm
弹药	danyao	dy
弹词	tanci	tc
弹跳	tantiao	tt
弹道	dandao	dd
强人	qiangren	qr
强人所难	qiangrensuonan	qrsn
强似	qiangsi	qs
强使	qiangshi	qs
强健	qiangjian	qj
强击机	qiangjiji	qjj
强制	qiangzhi	qz
强力	qiangli	ql
强加	qiangjia	qj
强劲	qiangjing	qj
强化	qianghua	qh
强占	qiangzhan	qz
强压	qiangya	qy
强告化	qianggaohua	qgh
强嘴	jiangzui	jz
强固	qianggu	qg
强国	qiangguo	qg
强壮	qiangzhuang	qz
强大	qiangda	qd
强奸	qiangjian	qj
强度	qiangdu	qd
强弩之末	qiangnuzhimo	qnzm
强心剂	qiangxinji	qxj
强手	qiangshou	qs
强攻	qianggong	qg
强暴	qiangbao	qb
强权	qiangquan	qq
强梁	qiangliang	ql
强横	qiangheng	qh
强求	qiangqiu	qq
强渡	qiangdu	qd
强烈	qianglie	ql
强盗	qiangdao	qd
强盛	qiangsheng	qs
强直	qiangzhi	qz
强硬	qiangying	qy
强行	qiangxing	qx
强行军	qiangxingjun	qxj
强词夺理	qiangciduoli	qcdl
强调	qiangdiao	qd
强身	qiangshen	qs
强辩	qiangbian	qb
强迫	qiangpo	qp
强逼	qiangbi	qb
强酸	qiangsuan	qs
强项	qiangxiang	qx
强颜	qiangyan	qy
强风	qiangfeng	qf
归宿	guisu	gs
归省	guising	g
归还	guihuan	gh
归降	guixiang	gx
当地	dangdi	dd
当行出色	danghangchuse	dhcs
往还	wanghuan	wh
征调	zhengdiao	zd
径行	jingxing	jx
徒长	tuzhang	tz
微行	weixing	wx
微调	weitiao	wt
德行	dexing	dx
德高望重	degaowangzhong	dgwz
徽调	huidiao	hd
心传	xinchuan	xc
心地	xindi	xd
心率	xinlv	xl
心盛	xinsheng	xs
心重	xinzhong	xz
忍辱负重	renrufuzhong	rrfz
快乐	kuaile	kl
忽地	hudi	hd
怎地	zendi	zd
急行军	jixingjun	jxj
性行	xingxing	xx
怪圈	guaiquan	gq
总长	zongzhang	zz
恁地	nendi	nd
悠长	youchang	yc
情调	qingdiao	qd
惊天动地	jingtiandongdi	jtdd
惊奇	jingqi	jq
惨重	canzhong	cz
感觉	ganjue	gj
感觉器官	ganjueqiguan	gjqg
慎重	shenzhong	sz
懂行	donghang	dh
戎行	ronghang	rh
成宿	chengxiu	cx
成行	chengxing	cx
成长	chengzhang	cz
我行我素	woxingwosu	wxws
或然率	huoranlv	hrl
战地	zhandi	zd
战天斗地	zhantiandoudi	ztdd
截长补短	jiechangbuduan	jcbd
户长	huzhang	hz
手榴弹	shouliudan	sld
手重	shouzhong	sz
扒头儿	batour	bte
扒手	pashou	ps
扒拉	pala	pl
扒灰	pahui	ph
扒犁	pali	pl
扒皮	bapi	bp
扒窃	paqie	pq
扒糕	pagao	pg
扒车	bache	bc
打击乐器	dajiyueqi	djyq
打圈子	daquanzi	dqz
打折扣	dazhekou	dzk
托管地	tuoguandi	tgd
扛长工	kangchanggong	kcg
执行	zhixing	zx
执行主席	zhixingzhuxi	zxzx
扫地	saodi	sd
扫地出门	saodichumen	sdcm
扬长	yangchang	yc
扬长避短	yangchangbiduan	ycbd
承重	chengzhong	cz
承重孙	chengzhongsun	czs
投宿	tousu	ts
投弹	toudan	td
投降	touxiang	tx
折中	zhezhong	zz
折价	zhejia	zj
折光	zheguang	zg
折兑	zhedui	zd
折冲	zhechong	zc
折冲樽俎	zhechongzunzu	zczz
折半	zheban	zb
折受	zheshou	zs
折变	zhebian	zb
折叠	zhedie	zd
折合	zhehe	zh
折回	zhehui	zh
折头	zhetou	zt
折子	zhezi	zz
折子戏	zhezixi	zzx
折实	zheshi	zs
折寿	zheshou	zs
折射	zheshe	zs
折尺	zhechi	zc
折干	zhegan	zg
折扇	zheshan	zs
折扣	zhekou	zk
折旧	zhejiu	zj
折服	zhefu	zf
折本	sheben	sb
折皱	zhezhou	zz
折磨	zhemo	zm
折福	zhefu	zf
折秤	shecheng	sc
折算	zhesuan	zs
折箩	zheluo	zl
折纸	zhezhi	zz
折线	zhexian	zx
折耗	shehao	sh
折腰	zheyao	zy
折腾	zheteng	zt
折衷	zhezhong	zz
折衷主义	zhezhongzhuyi	zzzy
折账	zhezhang	zz
折辱	zheru	zr
抨弹	pengtan	pt
抵还	dihuan	dh
抽调	choudiao	cd
拈轻怕重	nianqingpazhong	nqpz
拔苗助长	bamiaozhuzhangya	bmzz
拘传	juchuan	jc
招降	zhaoxiang	zx
招降纳叛	zhaoxiangnapan	zxnp
拜天地	baitiandi	btd
拿腔拿调	naqiangnadiao	nqnd
持重	chizhong	cz
挂屏	guaping	gp
挫折	cuozhe	cz
排行	paihang	ph
接地	jiedi	jd
接长不短	jiechangbuduan	jcbd
推行	tuixing	tx
推重	tuizhong	tz
掷地有声	zhidiyousheng	zdys
掷弹筒	zhidantong	zdt
掷还	zhihuan	zh
提行	tihang	th
提调	tidiao	td
插屏	chaping	cp
揠苗助长	yamiaozhuzhang	ymzz
摄行	shexing	sx
摇滚乐	yaogunyue	ygy
摧折	cuizhe	cz
摧眉折腰	cuimeizheyao	cmzy
撂地	liaodi	ld
撼天动地	hantiandongdi	htdd
擅长	shanchang	sc
操行	caoxing	cx
攀折	panzhe	pz
改天换地	gaitianhuandi	gthd
改朝换代	gaichaohuandai	gchd
改行	gaihang	gh
攻城略地	gongchenglvedi	gcld
立地成佛	lidichengfo	ldcf
放行	fangxing	fx
放还	fanghuan	fh
故地	gudi	gd
故都	gudu	gd
效率	xiaolv	xl
救生圈	jiushengquan	jsq
教学相长	jiaoxuexiangzhang	jxxz
敬重	jingzhong	jz
整地	zhengdi	zd
斜率	xielv	xl
斥地	chidi	cd
断行	duanxing	dx
斯文扫地	siwensaodi	swsd
新奇	xinqi	xq
施行	shixing	sx
旅行	lvxing	lx
旅行社	lvxingshe	lxs
族长	zuzhang	zz
无地自容	wudizirong	wdzr
无奇不有	wuqibuyou	wqby
无行	wuxing	wx
无足轻重	wuzuqingzhong	wzqz
日久天长	rijiutianchang	rjtc
旧地	jiudi	jd
旧调重弹	jiudiaochongtan	jdzd
旧都	jiudu	jd
旱地	handi	hd
时行	shixing	sx
时调	shidiao	sd
旺盛	wangsheng	ws
昌盛	changsheng	cs
明朝	mingzhao	mz
昏天黑地	huntianheidi	hthd
星宿	xingxiu	xx
晌觉	shangjiao	sj
暂行	zanxing	zx
暗地里	andili	adl
暗射地图	ansheditu	asdt
暴行	baoxing	bx
曲折	quzhe	qz
曲率	qulv	ql
曲调	qudiao	qd
曳光弹	yeguangdan	ygd
曾几何时	cengjiheshi	cjhs
曾孙	zengsun	zs
曾孙女	zengsunnv	zsn
曾祖	zengzu	zz
曾祖母	zengzumu	zzm
曾经	cengjing	cj
曾经沧海	cengjingcanghai	cjch
有朝一日	youzhaoyiri	yzyr
服务行业	fuwuhangye	fwhy
朝三暮四	zhaosanmusi	zsms
朝不保夕	zhaobubaoxi	zbbx
朝乾夕惕	zhaoqianxiti	zqxt
朝代	chaodai	cd
朝令夕改	zhaolingxigai	zlxg
朝发夕至	zhaofaxizhi	zfxz
朝向	chaoxiang	cx
朝圣	chaosheng	cs
朝夕	zhaoxi	zx
朝奉	chaofeng	cf
朝山	chaoshan	cs
朝廷	chaoting	ct
朝拜	chaobai	cb
朝政	chaozheng	cz
朝日	zhaori	zr
朝晖	zhaohui	zh
朝服	chaofu	cf
朝气	zhaoqi	zq
朝珠	chaozhu	cz
朝秦暮楚	zhaoqinmuchu	zqmc
朝纲	chaogang	cg
朝见	chaojian	cj
朝觐	chaojin	cj
朝贡	chaogong	cg
朝野	chaoye	cy
朝阳	chaoyang	cy
朝阳花	chaoyanghua	cyh
朝霞	zhaoxia	zx
朝露	zhaolu	zl
朝顶	chaoding	cd
朝鲜族	chaoxianzu	cxz
木强	mujiang	mj
未曾	weiceng	wc
本地	bendi	bd
本行	benhang	bh
机械效率	jixiexiaolv	jxxl
来日方长	lairifangchang	lrfc
杵乐	chuyue	cy
极乐世界	jileshijie	jlsj
极圈	jiquan	jq
极地	jidi	jd
构造地震	gouzaodizhen	gzdz
枪弹	qiangdan	qd
枪林弹雨	qianglindanyu	qldy
枪榴弹	qiangliudan	qld
标题音乐	biaotiyinyue	btyy
树碑立传	shubeilizhuan	sblz
树行子	shuhangzi	shz
校长	xiaozhang	xz
核弹	hedan	hd
核弹头	hedantou	hdt
根据地	genjudi	gjd
格调	gediao	gd
棚圈	pengjuan	pj
概率	gailv	gl
榴弹	liudan	ld
榴弹炮	liudanpao	ldp
榴霰弹	liuxiandan	lxd
横行	hengxing	hx
横行霸道	hengxingbadao	hxbd
橡皮圈	xiangpiquan	xpq
欢乐	huanle	hl
欢天喜地	huantianxidi	htxd
欺行霸市	qihangbashi	qhbs
歇宿	xiesu	xs
此地	cidi	cd
步行	buxing	bx
步调	budiao	bd
武行	wuhang	wh
死亡率	siwanglv	swl
死地	sidi	sd
死心塌地	sixintadi	sxtd
殖民地	zhimindi	zmd
比率	bilv	bl
比重	bizhong	bz
毛重	maozhong	mz
民乐	minyue	my
气贯长虹	qiguanchanghong	qgch
氢弹	qingdan	qd
水地	shuidi	sd
永乐	yongle	yl
汇率	huilv	hl
汉调	handiao	hd
沉重	chenzhong	cz
沉降	chenjiang	cj
油腔滑调	youqianghuadiao	yqhd
泊地	bodi	bd
波尔卡	boerkapolka	bek
波折	bozhe	bz
波长	bochang	bc
注重	zhuzhong	zz
洋行	yanghang	yh
洞天福地	dongtianfudi	dtfd
洲际导弹	zhoujidaodan	zjdd
活地图	huoditu	hdt
活地狱	huodiyu	hdy
洼地	wadi	wd
流传	liuchuan	lc
流弹	liudan	ld
流行	liuxing	lx
流行歌曲	liuxinggequ	lxgq
流行病	liuxingbing	lxb
流行色	liuxingse	lxs
浓墨重彩	nongmozhongcai	nmzc
浓重	nongzhong	nz
浮动汇率	fudonghuilv	fdhl
海外奇谈	haiwaiqitan	hwqt
消长	xiaozhang	xz
涤卡	dika	dk
深恶痛觉	shenwutongjue	setj
深水炸弹	shenshuizhadan	sszd
深省	shenxing	sx
深重	shenzhong	sz
深长	shengchang	sc
清还	qinghuan	qh
温觉	wenjue	wj
游乐	youle	yl
游标卡尺	youbiaokachi	ybkc
游行	youxing	yx
源远流长	yuanyuanliuchang	yylc
滋长	zizhang	zz
滑行	huaxing	hx
滥调	landiao	ld
滩地	tandi	td
漫长	manchang	mc
潜行	qianxing	qx
火力圈	huoliquan	hlq
火山地震	huoshandizhen	hsdz
火箭弹	huojiandan	hjd
灭此朝食	miecizhaoshi	mczs
炮弹	paodan	pd
炸弹	zhadan	zd
炽盛	chisheng	cs
烟幕弹	yanmudan	ymd
烧夷弹	shaoyidan	syd
热传导	rechuandao	rcd
热效率	rexiaolv	rxl
热火朝天	rehuochaotian	rhct
烹调	pengtiao	pt
照明弹	zhaomingdan	zmd
熟地	shudi	sd
燃烧弹	ranshaodan	rsd
爬行	paxing	px
爬行动物	paxingdongwu	pxdw
爵士乐	jueshiyuejazz	jsy
片子地	pianzidi	pzd
牙行	yahang	yh
牵强	qianqiang	qq
特地	tedi	td
特长	techang	tc
独断专行	duduanzhuanxing	ddzx
独行	duxing	dx
狭长	xiachang	xc
猛省	mengxing	mx
率先	shuaixian	sx
率尔	shuaier	se
率性	shuaixing	sx
率然	shuairan	sr
率由旧章	shuaiyoujiuzhang	syjz
率直	shuaizhi	sz
率真	shuaizhen	sz
率领	shuailing	sl
王朝	wangchao	wc
玩乐	wanle	wl
环行	huanxing	hx
现行	xianxing	xx
现行法	xianxingfa	xxf
现行犯	xianxinfan	xf
珍奇	zhenqi	zq
珍重	zhenzhong	zz
瑰奇	guiqi	gq
璧还	bihuan	bh
瓦圈	waquan	wq
生产率	shenchanlv	scl
生地	shengdi	sd
生物圈	shengwuquan	swq
生荒地	shenghuangdi	shd
生还	shenghuan	sh
生长	shengzhang	sz
用舍行藏	yongshexingcang	ysxz
田地	tiandi	td
电功率	diangonglv	dgl
电子音乐	dianziyinyue	dzyy
电流强度	dianliuqiangdu	dlqd
画地为牢	huadiweilao	hdwl
画屏	huaping	hp
画行	huaxing	hx
畅行	changxing	cx
留余地	liuyudi	lyd
留宿	liusu	ls
畸轻畸重	jiqingjizhong	jqjz
疯长	fengzhang	fz
痛觉	tongjie	t
痴长	chizhang	cz
瘦长	shouchang	sc
白兰地	bailandibrandy	bld
白地	baidi	bd
百分率	baifenlv	bfl
百折不挠	baizhebunao	bzbn
皇朝	huangchao	hc
皮重	pizhong	pz
盆地	pendi	pd
盐碱地	yanjiandi	yjd
监外执行	jianwaizhixing	jwzx
盘根问地	pangenwendi	pgwd
盛世	shengshi	ss
盛举	shengju	sj
盛事	shengshi	ss
盛产	shengchan	sc
盛会	shenghui	sh
盛传	shengchuan	sc
盛典	shengdian	sd
盛况	shengkuang	sk
盛名	shengming	sm
盛器	chengqi	cq
盛夏	shengxia	sx
盛大	shengda	sd
盛宴	shengyan	sy
盛年	shengnian	sn
盛开	shengkai	sk
盛怒	shengnu	sn
盛情	shengqing	sq
盛意	shengyi	sy
盛暑	shengshu	ss
盛服	shengfu	sf
盛气凌人	shengqilingren	sqlr
盛行	shengxing	sx
盛装	shengzhuang	sz
盛誉	shengyu	sy
盛赞	shengzan	sz
盛馔	shengzhuan	sz
直率	zhishuai	zs
直觉	zhijue	zj
相传	xiangchuan	xc
相率	xiangshuai	xs
相辅而行	xiangfuerxing	xfex
省事	shengshi	ss
省亲	xingqin	xq
省份	shengfen	sf
省会	shenghui	sh
省便	shengbian	sb
省俭	shengjian	sj
省却	shengque	sq
省垣	shengyuan	sy
省城	shengcheng	sc
省墓	xingmu	xm
省察	xingcha	xc
省得	shengde	sd
省心	shengxin	sx
省悟	xingwu	xw
省治	shengzhi	sz
省略	shenglve	sl
省略号	shenglvehao	slh
省视	xingshi	xs
看重	kanzhong	kz
真传	zhenchuan	zc
真率	zhenshuai	zs
眼圈	yanquan	yq
着重	zhuozhong	zz
着重号	zhuozhonghao	zzh
睡懒觉	shuilanjiao	slj
睡觉	shuijiao	sj
知觉	zhijue	zj
破折号	pozhehao	pzh
破镜重圆	pojingchongyuan	pjcy
碱地	jiandi	jd
磁场强度	cichangqiangdu	ccqd
磨折	mozhe	mz
祖传	zuchuan	zc
祖率	zulv	zl
鬼不觉	guibujue	gbj
神奇	shenqi	sq
祸不单行	huobudanxing	hbdx
禁地	jindi	jd
福地	fudi	fd
离奇	liqi	lq
种地	zhongdi	zd
租借地	zujiedi	zjd
积重难返	jizhongnanfan	jznf
称奇	chengji	cj
秽行	huixing	hx
稀奇	xiqi	xq
税卡	shuiqia	sq
税率	shuilv	sl
稳重	wenzhong	wz
空包弹	kongbaodan	kbd
空地	kongdi	kd
空调	kongtiao	kt
空降	kongjiang	kj
穿甲弹	chuanjiadan	cjd
穿行	chuanxing	cx
立地	lidi	ld
立锥之地	lizhuizhidi	lzzd
笔调	bidiao	bd
笨重	benzhong	bz
策源地	ceyuandi	cyd
简省	jiansheng	js
管乐器	guanyueqi	gyq
管弦乐	guanxianyue	gxy
粗率	cushuai	cs
粗重	cuzhong	cz
粘贴	zhantie	zt
粘连	zhanlian	zl
精明强干	jingmingqianggan	jmqg
糖弹	tangdan	td
糖衣炮弹	tangyipaodan	typd
繁盛	fansheng	fs
繁重	fanzhong	fz
纤长	xianchang	xc
纪传体	jizhuanti	jzt
纪行	jixing	jx
纳降	naxiang	nx
线圈	xianquan	xq
细水长流	xishuichangliu	xscl
经传	jingzhuan	jz
经天纬地	jingtianweidi	jtwd
绕圈子	raoquanzi	rqz
绝地	juedi	jd
统率	tongshuai	ts
绵长	mianchang	mc
绿卡	lvka	lk
绿地	lvdi	ld
缓行	huanxing	hx
罗圈	luoquan	lq
罗圈儿揖	luoquanryi	lqey
罗圈腿	luoquantui	lqt
罪行	zuixing	zx
群轻折轴	qunqingzhezhou	qqzz
翻天覆地	fantianfudi	ftfd
老成持重	laochengchizhong	lccz
老调	laodiao	ld
耆宿	qisu	qs
耕地	gengdi	gd
耳屏	erping	ep
肆行	sixing	sx
肝脑涂地	gannaotudi	gntd
肤觉	fujue	fj
背地	beidi	bd
胜地	shengdi	sd
胜朝	shengchao	sc
胳膊肘朝外拐	gebozhouchaowaiguai	gbzcwg
胶粘剂	jiaozhanji	jzj
脚行	jiaohang	jh
脚踏实地	jiaotashidi	jtsd
腔调	qiangdiao	qd
腹地	fudi	fd
自传	zizhuan	zz
自强	ziqiang	zq
自强不息	ziqiangbuxi	zqbx
自留地	ziliudi	zld
自行	zixing	zx
自行其是	zixingqishi	zxqs
自行火炮	zixinghuopao	zxhp
自行车	zixingche	zxc
自觉	zijue	zj
自觉自愿	zijueziyuan	zjzy
自重	zizhong	zz
航行	hangxing	hx
船长	chuanzhang	cz
色觉	sejue	sj
色调	sediao	sd
节省	jiesheng	js
花圈	huaquan	hq
花天酒地	huatianjiudi	htjd
花朝	huazhao	hz
苦行	kuxing	kx
苦行僧	kuxingseng	kxs
茁长	zhuozhang	zz
茂盛	maosheng	ms
草地	caodi	cd
草率	caoshuai	cs
荒地	huangdi	hd
荧光屏	yingguangping	ygp
荧屏	yingping	yp
荷枪实弹	heqiangshidan	hqsd
荷重	hezhong	hz
营地	yingdi	yd
落地	luodi	ld
落地灯	luodideng	ldd
落地窗	luodichuang	ldc
蒙太奇	mengtaiqimontage	mtq
蓦地	modi	md
薄地	bodi	bd
薪尽火传	xinjinhuochuan	xjhc
蛇行	shexing	sx
蜚短流长	feiduanliuchang	fdlc
蟾宫折桂	changongzhegui	cgzg
行业	hangye	hy
行业语	hangyeyu	hyy
行东	hangdong	hd
行为	xingwei	xw
行为能力	xingweinengli	xwnl
行乐	xingle	xl
行乞	xingqi	xq
行书	xingshu	xs
行事	xingshi	xs
行云流水	xingyunliushui	xyls
行人	xingren	xr
行人情	xingrenqing	xrq
行令	xingling	xl
行伍	hangwu	hw
行会	hanghui	hh
行使	xingshi	xs
行军	xingjun	xj
行军床	xingjunchuang	xjc
行凶	xingxiong	xx
行刑	xingxing	xx
行列	hanglie	hl
行刺	xingci	xc
行动	xingdong	xd
行劫	xingjie	xj
行医	xingyi	xy
行商	xingshang	xs
行善	xingshan	xs
行囊	xingnang	xn
行头	xingtou	xt
行好	xinghao	xh
行子	hangzi	hz
行宫	xinggong	xg
行家	hangjia	hj
行将	xingjiang	xj
行将就木	xingjiangjiumu	xjjm
行尸走肉	xingshizourou	xszr
行市	hangshi	hs
行帮	hangbang	hb
行当	hangdang	hd
行径	xingjing	xj
行情	hangqing	hq
行房	xingfang	xf
行政	xingzheng	xz
行政公署	xingzhenggongshu	xzgs
行政区	xingzhengqu	xzq
行政拘留	xingzhengjuliu	xzjl
行文	xingwen	xw
行方便	xingfangbian	xfb
行旅	xinglv	xl
行时	xingshi	xs
行星	xingxing	xx
行期	xingqi	xq
行李	xingli	xl
行李卷儿	xinglijuanr	xlje
行栈	hangzhan	hz
行格势禁	xinggeshijin	xgsj
行楷	xingkai	xk
行款	hangkuan	hk
行止	xingzhi	xz
行状	xingzhuang	xz
行猎	xinglie	xl
行礼	xingli	xl
行程	xingcheng	xc
行窃	xingqie	xq
行箧	xingqie	xq
行经	xingjing	xj
行署	xingshu	xs
行者	xingzhe	xz
行脚	xingjiao	xj
行腔	xingqiang	xq
行船	xingchuan	xc
行色	xingse	xs
行若无事	xingruowushi	xrws
行草	xingcao	xc
行营	xingying	xy
行藏	xingcang	xz
行装	xingzhuang	xz
行规	hanggui	hg
行话	hanghua	hh
行货	hanghuo	hh
行贩	hangfan	hf
行贿	xinghui	xh
行走	xingzou	xz
行距	hangju	hj
行踪	xingzong	xz
行车	hangche	hc
行辈	hangbei	hb
行辕	xingyuan	xy
行进	xingjin	xj
行述	xingshu	xs
行迹	xingji	xj
行道	hangdao	hd
行道树	xingdaoshu	xds
行都	xingdu	xd
行销	xingxiao	xx
行销骨立	xingxiaoguli	xxgl
行间	hangjian	hj
行院	hangyuan	hy
行驶	xingshi	xs
衣锦还乡	yijinhuanxiang	yjhx
衣食住行	yishizhuxing	yszx
表率	biaoshuai	bs
西乐	xiyue	xy
要价还价	yaojiahuanjia	yjhj
要地	yaodi	yd
要强	yaoqiang	yq
见地	jiandi	jd
见长	jianchang	jc
规行矩步	guixingjubu	gxjb
视觉	shijue	sj
觉察	juecha	jc
觉得	juede	jd
觉悟	juewu	jw
觉醒	juexing	jx
触觉	chujue	cj
言传	yanchuan	yc
言传身教	yanchuanshenjiao	ycsj
言归正传	yanguizhengzhuan	ygzz
言行	yanxing	yx
言重	yanzhong	yz
警觉	jingjue	jj
讨价还价	taojiahuanjia	tjhj
讨还	taohuan	th
议长	yizhang	yz
讹传	echuan	ec
论调	lundiao	ld
设身处地	sheshenchudi	sscd
评传	pingzhuan	pz
评弹	pingtan	pt
诈降	zhaxiang	zx
词调	cidiao	cd
试行	shixing	sx
诡奇	guiqi	gq
语调	yudiao	yd
语重心长	yuzhongxinchang	yzxz
诱降	youxiang	yx
说长道短	shuochangdaoduan	scdd
请调	qingdiao	qd
请降	qingxiang	qx
诸宫调	zhugongdiao	zgd
调令	diaoling	dl
调价	tiaojia	tj
调任	diaoren	dr
调侃	tiaokan	tk
调侃儿	diaokanr	dke
调值	diaozhi	dz
调停	tiaoting	tt
调养	tiaoyang	ty
调函	diaohan	dh
调制	tiaozhi	tz
调剂	tiaoji	tj
调动	diaodong	dd
调匀	tiaoyun	ty
调包	tiaobao	tb
调协	tiaoxie	tx
调卷	diaojuan	dj
调号	diaohao	dh
调味	tiaowei	tw
调和	tiaohe	th
调和漆	tiaoheqi	thq
调唆	tiaosuo	ts
调嘴学舌	tiaozuixueshe	tzxs
调处	tiaochu	tc
调头	diaotou	dt
调子	diaozi	dz
调幅	tiaofu	tf
调度	diaodu	dd
调弄	tiaonong	tn
调式	diaoshi	ds
调情	tiaoqing	tq
调戏	tiaoxi	tx
调护	tiaohu	th
调拨	diaobo	db
调换	diaohuan	dh
调控	tiaokong	tk
调摄	tiaoshe	ts
调教	tiaojiao	tj
调整	tiaozheng	tz
调料	tiaoliao	tl
调查	diaocha	dc
调治	tiaozhi	tz
调派	diaopai	dp
调演	diaoyan	dy
调理	tiaoli	tl
调用	diaoyong	dy
调皮	tiaopi	tp
调研	diaoyan	dy
调笑	tiaoxiao	tx
调类	diaolei	dl
调级	tiaoji	tj
调经	tiaojing	tj
调羹	tiaogeng	tg
调职	diaozhi	dz
调节	tiaojie	tj
调虎离山	diaohulishan	dhls
调解	tiaojie	tj
调试	tiaoshi	ts
调调	diaodio	dd
调谐	tiaoxie	tx
调谑	tiaoxue	tx
调资	tiaozi	tz
调转	diaozhuan	dz
调运	diaoyun	dy
调遣	diaoqian	dq
调配	diaopei	dp
调门儿	diaomenr	dme
调防	diaofang	df
调集	diaoji	dj
调频	tiaopin	tp
谈天说地	tantianshuodi	ttsd
谐调	xietiao	xt
谢天谢地	xietianxiedi	xtxd
谣传	yaochuan	yc
谷地	gudi	gd
谿卡	xika	qk
豪强	haoqiang	hq
负利率	fulilv	fll
负重	fuzhongb	fz
质地	zhidi	zd
贵重	guizhong	gz
贺卡	heka	hk
贿赂公行	huilugongxing	hlgx
赤地	chidi	cd
走调儿	zoudiaor	zde
起圈	qijuan	qj
起行	qixing	qx
起重机	qizhongji	qzj
起重船	qizhongchuan	qzc
超重	chaozhong	cz
跑调儿	paodiaor	pde
跳行	tiaohang	th
身体力行	shentilixing	stlx
身长	shenchang	sc
躬行	gongxing	gx
车圈	chequan	cq
转圈	zhuanquan	zq
转折	zhuanzhe	zz
转折点	zhuanzhedian	zzd
转行	zhuanhang	zh
转调	zhuandiao	zd
轻率	qingshuai	qs
轻省	qingsheng	qs
轻重	qingzhong	qz
轻重倒置	qingzhongdaozhi	qzdz
轻重缓急	qingzhonghuanji	qzhj
轻音乐	qingyinyue	qyy
载重	zaizhong	zz
辈行	beihang	bh
辎重	zizhong	zz
辞行	cixing	cx
边卡	bianqia	bq
边地	biandi	bd
达姆弹	damudandumdum	dmd
迁都	qiandu	qd
运行	yunxing	yx
近地点	jindidian	jdd
返老还童	fanlaohuantong	flht
返还	fanhuan	fh
还价	huanjia	hj
还俗	huansu	hs
还债	huanzhai	hz
还击	huanji	hj
还原	huanyuan	hy
还口	huankou	hk
还嘴	huanzui	hz
还席	huanxi	hx
还情	huanqing	hq
还愿	huanyuan	hy
还手	huanshou	hs
还报	huanbao	hb
还是	haishihai	hs
还本	huanben	hb
还礼	huanli	hl
还账	huanzhang	hz
还阳	huanyang	hy
还魂	huanhun	hh
进行	jinxing	jx
进行曲	jinxingqu	jxq
远地点	yuandidian	ydd
迫降	pojiang	pj
迹地	jidi	jd
退行	tuixing	tx
退还	tuihuan	th
送行	songxing	sx
逆水行舟	nishuixingzhou	nsxz
逆行	nixing	nx
选调	xuandiao	xd
递降	dijiang	dj
逗乐儿	douler	dle
通宿	tongxiu	tx
通行	tongxing	tx
通行证	tongxingzheng	txz
通都大邑	tongdudayi	tddy
逞强	chengqiang	cq
速率	sulv	sl
逸乐	yile	yl
遍地	biandi	bd
遍地开花	biandikaihua	bdkh
道地	daodi	dd
道行	daoheng	dh
遗传	yichuan	yc
遗传学	yichuanxue	ycx
遗传工程	yichuangongcheng	ycgc
遵行	zunxing	zx
避重就轻	bizhongjiuqing	bzjq
邪行	xiexing	xx
郑重	zhengzhong	zz
都会	duhui	dh
都城	ducheng	dc
都市	dushi	ds
都督	dudu	dd
酆都	fengdu	fd
酆都城	fengducheng	fdc
酋长	qiuzhang	qz
酋长国	qiuzhangguo	qzg
配乐	peiyue	py
里急后重	lijihouzhong	ljhz
重九	chongjiu	cj
重五	chongwu	cw
重价	zhongjia	zj
重任	zhongren	zr
重伤	zhongshang	zs
重修	chongxiu	cx
重修旧好	chongxiujiuhao	cxjh
重元素	zhongyuansu	zys
重光	chongguang	cg
重兵	zhongbing	zb
重出	chongchu	cc
重创	zhongchuang	zc
重利	zhongli	zl
重力	zhongli	zl
重办	zhongban	zb
重午	chongwu	cw
重印	chongyin	cy
重叠	chongdie	cd
重合	chonghe	ch
重名	chongming	cm
重听	zhongting	zt
重唱	chongchang	cc
重围	chongwei	cw
重圆	chongyuan	cy
重地	zhongdi	zd
重型	zhongxing	zx
重复	chongfu	cf
重大	zhongda	zd
重头戏	zhongtouxi	ztx
重奏	chongzou	cz
重奖	zhongjiang	zj
重婚	chonghun	ch
重子	zhongzi	zz
重孙	chongsun	cs
重孙女	chongsunnv	csn
重孝	zhongxiao	zx
重审	chongshen	cs
重峦叠嶂	chongluandiezhang	cldz
重工业	zhonggongye	zgy
重张	chongzhang	cz
重彩	zhongcai	zc
重心	zhongxin	zx
重托	zhongtuo	zt
重担	zhongdan	zd
重播	chongbo	cb
重整旗鼓	chongzhengqigu	czqg
重文	chongwen	cw
重新	chongxin	cx
重机关枪	zhongjiguanqiang	zjgq
重样	chongyang	cy
重武器	zhongwuqi	zwq
重氢	zhongqingda	zq
重沓	chongta	ct
重洋	chongyang	cy
重活	zhonghuo	zh
重温旧梦	chongwenjiumeng	cwjm
重演	chongyan	cy
重炮	zhongpao	zp
重点	zhongdian	zd
重版	chongban	cb
重犯	zhongfan	zf
重瓣胃	chongbanwei	cbw
重生	chongsheng	cs
重生父母	chongshengfumu	csfm
重用	zhongyong	zy
重申	chongshen	cs
重臂	zhongbi	zb
重茧	chongjian	cj
重茬	chongcha	cc
重落	chongluo	cl
重行	chongxing	cx
重要	zhongyao	zy
重见天日	chongjiantianri	cjtr
重视	zhongshi	zs
重言	chongyan	cy
重译	chongyi	cy
重话	zhonghua	zh
重读	zhongdu	zd
重负	zhongfu	zf
重责	zhongze	zz
重资	zhongzi	zz
重足而立	chongzuerli	czel
重趼	chongjian	cj
重蹈覆辙	chongdaofuzhe	cdfz
重身子	zhongshenzi	zsz
重逢	chongfeng	cf
重重	chongchong	cz
重量	zhongliang	zl
重金	zhongjin	zj
重金属	zhongjinshu	zjs
重镇	zhongzhen	zz
重阳	chongyang	cy
重霄	chongxiao	cx
重音	zhongyin	zy
野地	yedi	yd
银屏	yinping	yp
银行	yinhang	yh
铺天盖地	putiangaidi	ptgd
销行	xiaoxing	xx
锄强扶弱	chuqiangfuruo	cqfr
错觉	cuojue	cj
锚地	maodi	md
键盘乐器	jianpanyueqi	jpyq
长上	zhangshang	zs
长久	changjiu	cj
长于	changyu	cy
长亭	changting	ct
长亲	zhangqin	zq
长假	changjia	cj
长别	changbie	cb
长势	zhangshi	zs
长卷	changjuan	cj
长号	changhao	ch
长叹	changtan	ct
长吁短叹	changxuduantan	cydt
长命锁	changmingsuo	cms
长圆	changyuan	cy
长城	changcheng	cc
长处	changchu	cc
长夜	changye	cy
长天	changtian	ct
长子	zhangzi	zz
长孙	zhangsun	zs
长安	changan	ca
长官	zhangguan	zg
长寿	changshou	cs
长尾巴	zhangweiba	zwb
长局	changju	cj
长川	changchuan	cc
长工	changgong	cg
长年	changnian	cn
长年累月	changnianleiyue	cnly
长庚	changgeng	cg
长度	changdu	cd
长征	changzheng	cz
长性	changxing	cx
长房	zhangfang	zf
长支	changzhi	cz
长斋	changzhai	cz
长方体	changfangti	cft
长方形	changfangxing	cfx
长日照植物	changrizhaozhiwu	crzzw
长明灯	changmingdeng	cmd
长期	changqi	cq
长机	zhangji	zj
长枪	changqiang	cq
长款	changkuan	ck
长裤	changku	ck
长歌当哭	changgedangku	cgdk
长此以往	changciyiwang	ccyw
长毛绒	changmaorong	cmr
长河	changhe	ch
长治久安	changzhijiuan	czja
长法	changfa	cf
长波	changbo	cb
长活	changhuo	ch
长物	changwuzha	cw
长生	changsheng	cs
长生果	changshengguo	csg
长相	zhangxiang	zx
长眠	changmian	cm
长短	changduan	cd
长短句	changduanju	cdj
长程	changcheng	cc
长空	changkong	ck
长笛	changdi	cd
长策	changce	cc
长篇	changpian	cp
长篇大论	changpiandalun	cpdl
长篇小说	changpianxiaoshuo	cpxs
长线	changxian	cx
长线产品	changxianchanpin	cxcp
长编	changbian	cb
长缨	changying	cy
长老	zhanglao	zl
长者	zhangzhe	zz
长脸	zhanglian	zl
长膘	zhangbiao	zb
长臂猿	changbiyuan	cby
长舌	changshe	cs
长虫	changchong	cc
长行	changxing	cx
长衫	changshan	cs
长袍儿	changpaor	cpe
长袖善舞	changxiushanwu	cxsw
长袖	changxiu	cx
长话短说	changhuaduanshuo	chds
长足	changzu	cz
长跑	changpao	cp
长辈	zhangbei	zb
长辞	changci	cc
长进	zhangjin	zj
长远	changyuan	cy
长途	changtu	ct
长逝	changshi	cs
长门	zhangmen	zm
长颈鹿	changjinglu	cjl
长驱	changqu	cq
长驱直入	changquzhiru	cqzr
长骨	changgu	cg
长鼓	changgu	cg
长龙	changlong	cl
问长问短	wenchangwenduan	wcwd
闷闷不乐	menmenbule	mmbl
防地	fangdi	fd
防弹	fangdan	fd
阵地	zhendi	zd
阶地	jiedi	jd
阿鼻地狱	abidiyuavici	abdy
陆地	ludi	ld
陈词滥调	chencilandiao	ccld
降临	jianglin	jl
降价	jiangjia	jj
降伏	xiangfu	xf
降低	jiangdi	jd
降半旗	jiangbanqi	jbq
降尘	jiangchen	jc
降幅	jiangfu	jf
降旗	jiangqi	jq
降服	xiangfu	xf
降格	jiangge	jg
降水	jiangshui	js
降温	jiangwen	jw
降班	jiangban	jb
降生	jiangsheng	js
降级	jiangji	jj
降结肠	jiangjiechang	jjc
降落	jiangluo	jl
降落伞	jiangluosan	jls
降表	xiangbiao	xb
降解	jiangjie	jj
降顺	xiangshun	xs
降龙伏虎	xianglongfuhu	xlfh
险地	xiandi	xd
陪都	peidu	pd
陷落地震	xianluodizhen	xldz
隆盛	longsheng	ls
隆重	longzhong	lz
随地	suidi	sd
随行就市	suihangjiushi	shjs
隔行	gehang	gh
隙地	xidi	xd
雁行	yanhang	yh
集散地	jisandi	jsd
雷厉风行	leilifengxing	llfx
霍地	huodi	hd
霜降	shuangjiang	sj
霰弹	xiandan	xd
露宿	lusu	ls
面包圈	mianbaoquan	mbq
鞭长莫及	bianchangmoji	bcmj
音乐	yinyue	yy
音强	yinqiang	yq
音调	yindiao	yd
音长	yinchang	yc
韵调	yundiao	yd
顶天立地	dingtianlidi	dtld
项圈	xiangquan	xq
顽强	wanqiang	wq
颀长	qichang	qc
预行	yuxing	yx
频传	pinchuan	pc
频率	pinlv	pl
风传	fengchuan	fc
风圈	fengquan	fq
风行	fengxing	fx
风调雨顺	fengtiaoyushun	ftys
风餐露宿	fengcanlusu	fcls
飞地	feidi	fd
飞弹	feidan	fd
飞短流长	feiduanliuchang	fdlc
飞行	feixing	fx
飞行员	feixingyuan	fxy
飞行器	feixingqi	fxq
餐风宿露	canfengsulu	cfsl
饮弹	yindanzho	yd
饯行	jianxing	jx
首都	shoudu	sd
首长	shouzhang	sz
驻地	zhudi	zd
骨折	guzhe	gz
高地	gaodi	gd
高山景行	gaoshanjingxing	gsjx
高强	gaoqiang	gq
高调	gaodiao	gd
鹅行鸭步	exingyabu	exyb
黑地	heidi	hd
鼎盛	dingsheng	ds
鼓乐	guyue	gy
高盛	gaosheng	gs
乐嘉	lejia	lj
雾都孤儿	wuduguer	wdge
陶行知	taoxingzhi	txz
折花	zhehua	zh
男腔女调	nanqiangnvdiao	nqnd